issn,doi-num,on_crossref,reference,asserted-by-cr,asserted-by-pub,ref-undefined,ref-num,year,doi
1070-9428 1314-2607,1,1,1,8,0,12,20,,10.3897/jhr.29.3529
1070-9428 1314-2607,1,1,1,3,0,13,16,,10.3897/jhr.30.4018
2090-3464 2090-3472,1,1,1,10,5,15,30,,10.1155/2013/245940
2090-3464 2090-3472,1,1,1,18,42,14,74,,10.1155/2014/640952
2090-3464 2090-3472,1,1,1,7,7,7,21,,10.1155/2013/710621
2090-3464 2090-3472,1,1,1,13,15,6,34,,10.4061/2011/468717
2356-6124 2356-7759,1,1,1,0,23,5,28,,10.1155/2015/349801
2356-6124 2356-7759,1,1,1,5,15,2,22,,10.1155/2017/7845963
2356-6124 2356-7759,1,1,1,0,57,9,66,,10.1155/2021/4492206
2356-6124 2356-7759,1,1,1,1,6,1,8,,10.1155/2014/514086
2079-8245 2308-1422,1,1,1,1,7,34,42,,10.4102/rw.v6i1.71
2079-8245 2308-1422,1,1,1,2,19,17,38,,10.4102/rw.v11i1.260
2079-8245 2308-1422,1,1,1,2,17,28,47,,10.4102/rw.v10i1.216
2332-8886,1,1,1,0,1,0,1,,10.1186/s42234-021-00070-y
2332-8886,1,1,1,0,44,7,51,,10.1186/s42234-019-0019-x
1477-9560,1,1,1,0,16,0,16,,10.1186/s12959-021-00347-x
1477-9560,1,1,1,105,0,7,112,,10.1186/s12959-021-00345-z
1477-9560,1,1,1,2,48,11,61,,10.1186/s12959-020-00249-4
1477-9560,1,1,1,4,31,9,44,,10.1186/s12959-021-00275-w
1477-9560,1,1,1,0,36,0,36,,10.1186/s12959-021-00339-x
2662-2300,1,1,1,4,17,16,37,,10.1186/s43031-021-00038-7
2662-2300,1,1,1,5,41,18,64,,10.1186/s43031-020-00030-7
2520-8225,1,1,1,0,9,4,13,,10.1186/s41984-021-00125-x
2520-8225,1,1,1,1,27,6,34,,10.1186/s41984-019-0063-6
2076-7633 2077-6853,1,1,1,1,8,48,57,,10.20537/2076-7633-2018-10-1-61-76
2076-7633 2077-6853,1,1,1,5,1,26,32,,10.20537/2076-7633-2017-9-6-981-991
2076-7633 2077-6853,1,1,1,0,10,4,14,,10.20537/2076-7633-2017-9-4-547-566
2076-7633 2077-6853,1,1,1,5,11,1,17,,10.20537/2076-7633-2018-10-3-295-303
2076-7633 2077-6853,1,1,1,1,5,14,20,,10.20537/2076-7633-2015-7-6-1221-1239
2076-7633 2077-6853,1,1,1,0,0,12,12,,10.20537/2076-7633-2013-5-5-883-891
2076-7633 2077-6853,1,1,1,1,5,2,8,,10.20537/2076-7633-2015-7-5-1047-1060
2076-7633 2077-6853,1,1,1,3,2,11,16,,10.20537/2076-7633-2012-4-4-781-792
2076-7633 2077-6853,1,1,1,1,4,3,8,,10.20537/2076-7633-2009-1-3-287-295
2076-7633 2077-6853,1,1,1,0,1,3,4,,10.20537/2076-7633-2010-2-4-349-357
2076-7633 2077-6853,1,1,1,4,13,3,20,,10.20537/2076-7633-2015-7-1-125-144
2076-7633 2077-6853,1,1,1,1,2,6,9,,10.20537/2076-7633-2009-1-1-5-12
2076-7633 2077-6853,1,1,1,0,0,3,3,,10.20537/2076-7633-2015-7-1-107-112
2076-7633 2077-6853,1,1,1,0,4,3,7,,10.20537/2076-7633-2009-1-2-217-223
2076-7633 2077-6853,1,1,1,2,7,2,11,,10.20537/2076-7633-2009-1-1-13-20
2364-1746 2364-1754,1,1,1,0,5,1,6,,10.1007/s41030-018-0063-9
2373-8731,1,1,1,22,0,1,23,,10.1097/TXD.0000000000001135
2373-8731,1,1,1,30,0,0,30,,10.1097/TXD.0000000000001227
2373-8731,1,1,1,29,0,0,29,,10.1097/TXD.0000000000001230
2373-8731,1,1,1,12,0,7,19,,10.1097/TXD.0000000000001121
2055-5822,1,1,1,0,5,0,5,,10.1002/ehf2.13186
2055-5822,1,1,1,0,20,3,23,,10.1002/ehf2.13187
2055-5822,1,1,1,0,32,3,35,,10.1002/ehf2.13189
2055-5822,1,1,1,0,33,1,34,,10.1002/ehf2.13216
2055-5822,1,1,1,0,29,2,31,,10.1002/ehf2.13261
2055-5822,1,1,1,0,9,8,17,,10.1002/ehf2.13158
2055-5822,1,1,1,0,25,2,27,,10.1002/ehf2.13082
2055-5822,1,1,1,0,20,1,21,,10.1002/ehf2.13127
2055-5822,1,1,1,0,37,3,40,,10.1002/ehf2.13098
1450-698X 1820-9289,1,1,1,0,3,0,3,,10.2298/SAJ0570057P
1450-698X 1820-9289,1,1,1,0,1,0,1,,10.2298/SAJ0469059P
1450-698X 1820-9289,1,1,1,0,12,0,12,,10.2298/SAJ0979101S
2391-5455,1,1,1,2,0,13,15,,10.1515/math-2020-0111
2391-5455,1,1,1,18,0,4,22,,10.1515/math-2018-0095
2391-5455,1,1,1,10,0,11,21,,10.1515/math-2018-0120
2391-5455,1,1,1,22,0,7,29,,10.1515/math-2018-0006
2391-5455,1,1,1,5,0,1,6,,10.1515/math-2018-0015
2575-8314,1,1,1,0,19,29,48,,10.1002/pan3.10150
2575-8314,1,1,1,0,70,14,84,,10.1002/pan3.10129
2575-8314,1,1,1,0,50,18,68,,10.1002/pan3.10242
2575-8314,1,1,1,1,58,18,77,,10.1002/pan3.10083
2575-8314,1,1,1,3,118,62,183,,10.1002/pan3.10088
2575-8314,1,1,1,2,39,49,90,,10.1002/pan3.10221
2053-8790,1,1,1,13,32,6,51,,10.1136/lupus-2020-000460
2053-8790,1,1,1,10,35,5,50,,10.1136/lupus-2021-000551
2617-3107 2617-7811,1,1,1,1,0,14,15,,10.37472/2617-3107-2020-3-08
2617-3107 2617-7811,1,1,1,5,0,43,48,,10.37472/2617-3107-2020-3-06
1560-9278 1997-4736,1,1,1,0,0,6,6,,10.21443/1560-9278-2017-20-3-547-555
1821-3944 2217-8392,1,1,1,21,0,12,33,,10.5937/ratpov58-33227
1817-4434 2415-2005,1,1,1,3,24,22,49,,10.4102/td.v14i2.486
1817-4434 2415-2005,1,1,1,0,16,11,27,,10.4102/td.v14i1.469
1958-9212,1,1,1,0,1,0,1,,10.4000/confins.17041
1958-9212,1,1,1,0,4,0,4,,10.4000/confins.40889
1958-9212,1,1,1,0,5,0,5,,10.4000/confins.41807
1958-9212,1,1,1,0,1,0,1,,10.4000/confins.36634
2104-3736,1,1,1,0,4,0,4,,10.4000/gss.2802
2104-3736,1,1,1,0,4,0,4,,10.4000/gss.830
2264-7082,1,1,1,0,19,0,19,,10.4000/tipa.1871
1772-9971,1,1,1,0,33,0,33,,10.4000/developpementdurable.11869
1772-9971,1,1,1,0,10,0,10,,10.4000/developpementdurable.2775
1772-9971,1,1,1,0,10,0,10,,10.4000/developpementdurable.9318
1772-9971,1,1,1,0,5,0,5,,10.4000/developpementdurable.8376
1772-9971,1,1,1,0,3,0,3,,10.4000/developpementdurable.10811
1772-9971,1,1,1,0,1,0,1,,10.4000/developpementdurable.1952
1772-9971,1,1,1,0,12,0,12,,10.4000/developpementdurable.19095
1772-9971,1,1,1,0,16,0,16,,10.4000/developpementdurable.10806
1772-9971,1,1,1,0,9,0,9,,10.4000/developpementdurable.2850
1772-9971,1,1,1,0,8,0,8,,10.4000/developpementdurable.18441
1772-9971,1,1,1,0,16,0,16,,10.4000/developpementdurable.18921
1772-9971,1,1,1,0,19,0,19,,10.4000/developpementdurable.19064
2090-2085 2090-2093,1,1,1,7,7,9,23,,10.1155/2013/952034
2090-2085 2090-2093,1,1,1,16,24,9,49,,10.1155/2011/631690
2090-2085 2090-2093,1,1,1,15,49,13,77,,10.1155/2013/502697
0891-060X 1651-2235,1,1,1,1,11,1,13,,10.3402/mehd.v23i0.17316
2090-6420 2090-6439,1,1,1,2,10,0,12,,10.1155/2011/612732
2090-6420 2090-6439,1,1,1,0,9,1,10,,10.1155/2015/624718
2090-6420 2090-6439,1,1,1,0,4,0,4,,10.1155/2017/4786510
2090-908X,1,1,1,4,123,44,171,,10.1155/2018/1451894
2090-908X,1,1,1,2,29,1,32,,10.1155/2016/3825645
2090-908X,1,1,1,6,176,10,192,,10.1155/2018/9464592
2090-908X,1,1,1,38,86,10,134,,10.6064/2012/428139
2090-908X,1,1,1,60,101,7,168,,10.6064/2012/545328
2090-908X,1,1,1,0,5,3,8,,10.1155/2016/1513946
1687-7381 1687-739X,1,1,1,1,11,2,14,,10.1155/2009/409873
2517-6323,1,1,1,3,0,28,31,,http://dx.doi.org/10.31757/euer.322
2517-6323,1,1,1,8,0,8,16,,10.31757/euer.231
1133-0953 1988-8740,1,1,1,0,38,15,53,,10.4995/raet.2018.10916
2340-4876,1,1,1,0,15,42,57,,10.4995/ijpme.2019.9469
2326-5507,1,1,1,3,28,93,124,,10.1080/23265507.2016.1164616
1679-4508 2317-6385,1,1,1,19,0,11,30,,10.31744/einstein_journal/2018ao4212
1679-4508 2317-6385,1,1,1,8,0,11,19,,10.1590/s1679-45082018ao4228
1679-4508 2317-6385,1,1,1,5,0,0,5,,10.1590/S1679-45082013000400023
1679-4508 2317-6385,1,1,1,14,0,8,22,,10.1590/S1679-45082014AO2945
1679-4508 2317-6385,1,1,1,11,0,14,25,,10.1590/S1679-45082012000300014
1935-7877 1935-7885,1,1,1,0,5,11,16,,10.1128/jmbe.v14i1.492
1935-7877 1935-7885,1,1,1,0,6,5,11,,10.1128/jmbe.v16i2.926
1935-7877 1935-7885,1,1,1,0,20,3,23,,10.1128/jmbe.v21i1.2079
1935-7877 1935-7885,1,1,1,0,9,15,24,,10.1128/jmbe.v21i1.2091
1935-7877 1935-7885,1,1,1,0,41,8,49,,10.1128/jmbe.v21i2.2109
1935-7877 1935-7885,1,1,1,1,10,4,15,,10.1128/jmbe.v21i2.2227
1935-7877 1935-7885,1,1,1,0,10,12,22,,10.1128/jmbe.v21i2.2025
1935-7877 1935-7885,1,1,1,0,23,8,31,,10.1128/jmbe.v20i2.1700
1935-7877 1935-7885,1,1,1,0,24,2,26,,10.1128/jmbe.v20i2.1666
1935-7877 1935-7885,1,1,1,0,5,0,5,,10.1128/jmbe.v19i1.1467
1935-7877 1935-7885,1,1,1,0,8,8,16,,10.1128/jmbe.v19i1.1420
1935-7877 1935-7885,1,1,1,0,7,0,7,,10.1128/jmbe.v15i2.827
1935-7877 1935-7885,1,1,1,0,4,2,6,,10.1128/jmbe.v14i2.545
1935-7877 1935-7885,1,1,1,0,0,1,1,,10.1128/jmbe.v13i1.376
1935-7877 1935-7885,1,1,1,0,11,1,12,,10.1128/jmbe.v13i1.346
2335-7711 2351-714X,1,1,1,0,0,12,12,,10.3846/coactivity.2010.40
2335-7711 2351-714X,1,1,1,1,4,27,32,,10.3846/cpe.2015.273
2476-664X,1,1,1,1,74,5,80,,10.15171/ijbsm.2019.10
2059-8688 2059-8696,1,1,1,5,28,0,33,,10.1136/svn-2020-000413
2059-8688 2059-8696,1,1,1,2,9,1,12,,10.1136/svn-2021-001383
2059-8688 2059-8696,1,1,1,14,35,0,49,,10.1136/svn-2019-000274
1820-7448,1,1,1,28,0,12,40,,10.1515/acve-2016-0040
1820-7448,1,1,1,7,0,4,11,,10.2478/acve-2018-0029
1820-7448,1,1,1,19,0,5,24,,10.1515/acve-2017-0031
1820-7448,1,1,1,33,0,3,36,,10.2478/acve-2018-0016
1820-7448,1,1,1,34,0,10,44,,10.1515/acve-2017-0042
1820-7448,1,1,1,35,0,6,41,,10.2478/acve-2018-0032
1820-7448,1,1,1,91,0,13,104,,10.2478/acve-2020-0011
1820-7448,1,1,1,57,0,5,62,,10.2478/acve-2019-0026
1820-7448,1,1,1,29,0,6,35,,10.2478/acve-2021-0020
1820-7448,1,1,1,30,0,1,31,,10.2478/acve-2021-0003
1820-7448,1,1,1,35,0,3,38,,10.2478/acve-2021-0024
2531-4033,1,1,1,0,17,22,39,,10.3897/italianbotanist.12.76124
2531-4033,1,1,1,0,14,35,49,,10.3897/italianbotanist.12.78038
2001-0370,1,1,1,62,0,7,69,,10.5936/csbj.201301005
2001-0370,1,1,1,69,0,7,76,,10.5936/csbj.201204006
2001-0370,1,1,1,71,0,3,74,,10.1016/j.csbj.2014.10.004
2001-0370,1,1,1,20,0,6,26,,10.5936/csbj.201302009
2183-7635,1,1,1,26,0,39,65,,10.17645/up.v6i4.4406
2183-7635,1,1,1,42,0,15,57,,10.17645/up.v5i4.3414
2183-7635,1,1,1,19,0,27,46,,10.17645/up.v5i4.3426
2183-7635,1,1,1,18,0,29,47,,10.17645/up.v5i3.3092
2183-7635,1,1,1,1,0,18,19,,10.17645/up.v5i2.3322
2183-7635,1,1,1,29,0,23,52,,10.17645/up.v5i2.2940
2338-1604 2407-8751,1,1,1,0,9,0,9,,10.14710/jwl.8.3.247-260
2338-1604 2407-8751,1,1,1,0,20,0,20,,10.14710/jwl.8.3.290-306
0350-0241 2406-0739,1,1,1,0,1,0,1,,10.2298/STA0858163P
0350-0241 2406-0739,1,1,1,0,1,0,1,,10.2298/STA0959009C
2227-7072,1,1,1,1,25,4,30,,10.3390/ijfs4030013
2227-7072,1,1,1,1,13,14,28,,10.3390/ijfs9010012
2227-7072,1,1,1,1,21,14,36,,10.3390/ijfs6020034
2227-7072,1,1,1,0,35,10,45,,10.3390/ijfs9010016
2227-7072,1,1,1,10,52,6,68,,10.3390/ijfs8040078
2227-7072,1,1,1,0,28,18,46,,10.3390/ijfs5010004
2227-7072,1,1,1,2,26,40,68,,10.3390/ijfs8040063
2215-0013,1,1,1,49,0,12,61,,10.1016/j.scog.2015.03.002
2215-0013,1,1,1,33,0,7,40,,10.1016/j.scog.2016.04.003
2215-0013,1,1,1,87,0,4,91,,10.1016/j.scog.2015.06.002
2215-0013,1,1,1,46,0,5,51,,10.1016/j.scog.2015.11.004
2215-0013,1,1,1,36,0,11,47,,10.1016/j.scog.2017.04.001
1542-4278,1,1,1,0,11,34,45,,10.25222/larr.75
0716-078X 0717-6317,1,1,1,0,42,27,69,,10.1186/s40693-021-00102-6
2661-8850,1,1,1,0,19,1,20,,10.1186/s12860-021-00397-z
2730-6011,1,1,1,0,39,5,44,,10.1007/s12672-021-00451-4
2336-4912 2336-4920,1,1,1,1,15,13,29,,10.5507/ag.2014.011
2475-4455,1,1,1,0,54,8,62,,10.1002/pld3.363
2475-4455,1,1,1,0,66,2,68,,10.1002/pld3.188
2475-4455,1,1,1,0,50,4,54,,10.1002/pld3.203
2475-4455,1,1,1,0,53,2,55,,10.1002/pld3.205
2475-4455,1,1,1,1,30,2,33,,10.1002/pld3.257
2475-4455,1,1,1,1,55,2,58,,10.1002/pld3.208
2303-3592 2540-9301,1,1,1,0,1,20,21,,10.20473/jaki.v5i2.2017.145-154
2045-7022,1,1,1,0,33,7,40,,10.1002/clt2.12076
2411-4944 2415-301X,1,1,1,1,0,10,11,,10.11603/24116-4944.2019.1.10188
0368-4814 2587-9359,1,1,1,0,2,0,2,,10.17816/KMJ2019-381
0368-4814 2587-9359,1,1,1,0,1,0,1,,10.17816/KMJ2019-850
2317-1537 2317-1545,1,1,1,13,0,17,30,,10.1590/2317-1545v38n4164650
2317-1537 2317-1545,1,1,1,16,0,15,31,,10.1590/2317-1545v39n4188530
2317-1537 2317-1545,1,1,1,24,0,9,33,,10.1590/2317-1545v40n2175172
2010-135X 2010-1368,1,1,1,0,16,0,16,,10.1142/S2010135X18200023
2010-135X 2010-1368,1,1,1,0,37,8,45,,10.1142/S2010135X19500012
2010-135X 2010-1368,1,1,1,0,16,1,17,,10.1142/S2010135X19500073
2156-5872 2156-5899,1,1,1,1,17,27,45,,10.1177/2156587214524579
2156-5872 2156-5899,1,1,1,1,108,30,139,,10.1177/2156587216688597
0352-3462 2334-8453,1,1,1,5,0,14,19,,10.5937/ekoPolj2103823Z
0352-3462 2334-8453,1,1,1,10,0,13,23,,10.5937/ekoPolj2103713L
2090-2727 2090-2735,1,1,1,0,21,8,29,,10.1155/2016/1703809
2090-2727 2090-2735,1,1,1,2,13,1,16,,10.1155/2016/3658527
2090-2727 2090-2735,1,1,1,6,20,4,30,,10.1155/2012/620753
2090-2727 2090-2735,1,1,1,6,23,3,32,,10.1155/2013/139049
2058-4555 2058-4563,1,1,1,2,22,17,41,,10.14236/jhi.v25i4.1068
2058-4555 2058-4563,1,1,1,3,15,7,25,,10.14236/jhi.v25i3.1012
1848-5782,1,1,1,2,0,6,8,,10.1515/cirr-2015-0011
0005-1144 1848-3380,1,1,1,0,6,6,12,,10.1080/00051144.2018.1530827
2001-5992,1,1,1,1,0,12,13,,10.3384/VS.2001-5992.19611
1751-3758 1751-3766,1,1,1,1,24,1,26,,10.1080/17513758.2016.1213319
1751-3758 1751-3766,1,1,1,0,42,12,54,,10.1080/17513758.2020.1799083
1751-7192 1751-8253,1,1,1,0,12,8,20,,10.1080/17518253.2016.1163421
1751-7192 1751-8253,1,1,1,0,32,12,44,,10.1080/17518253.2017.1380236
1751-7192 1751-8253,1,1,1,0,24,5,29,,10.1080/17518253.2018.1445300
2166-5095,1,1,1,0,44,19,63,,10.1080/21665095.2018.1500143
1013-7025 1876-441X,1,1,1,1,14,1,16,,10.1142/S1013702518500129
2352-8273,1,1,1,61,0,31,92,,10.1016/j.ssmph.2017.07.010
2352-8273,1,1,1,24,0,12,36,,10.1016/j.ssmph.2017.10.002
1878-9293 1878-9307,1,1,1,219,0,17,236,,10.1016/j.dcn.2016.08.001
1598-9100 2288-1956,1,1,1,22,0,1,23,,10.5217/ir.2017.15.2.195
1598-9100 2288-1956,1,1,1,210,0,23,233,,10.5217/ir.2017.15.3.285
1598-9100 2288-1956,1,1,1,24,0,4,28,,10.5217/ir.2017.15.4.487
1598-9100 2288-1956,1,1,1,16,0,3,19,,10.5217/ir.2017.15.1.138
1598-9100 2288-1956,1,1,1,18,0,2,20,,10.5217/ir.2018.16.2.306
1869-9510 1869-9529,1,1,1,128,0,28,156,,10.5194/se-12-2573-2021
1869-9510 1869-9529,1,1,1,69,0,17,86,,10.5194/se-10-1269-2019
1869-9510 1869-9529,1,1,1,34,0,21,55,,10.5194/se-12-1005-2021
1869-9510 1869-9529,1,1,1,58,0,8,66,,10.5194/se-11-2499-2020
1869-9510 1869-9529,1,1,1,44,0,11,55,,10.5194/se-12-503-2021
2688-4526,1,1,1,0,25,16,41,,10.1002/bco2.87
2673-6861,1,1,1,1,25,6,32,,10.3389/fresc.2021.726761
2673-6861,1,1,1,0,183,2,185,,10.3389/fresc.2021.782848
2673-6861,1,1,1,1,38,1,40,,10.3389/fresc.2021.740426
0120-159X 2256-5485,1,1,1,0,0,6,6,,10.15446/rcs.v38n1.53285
2345-3362 2322-5866,1,1,1,0,7,17,24,,10.34172/ijep.2020.24
2345-3362 2322-5866,1,1,1,0,3,3,6,,10.34172/ijep.2020.16
2213-0071,1,1,1,11,0,0,11,,10.1016/j.rmcr.2017.08.022
2213-0071,1,1,1,3,0,2,5,,10.1016/j.rmcr.2015.11.002
2213-0071,1,1,1,20,0,2,22,,10.1016/j.rmcr.2016.01.003
0002-0397 1868-6869,1,1,1,0,30,59,89,,10.1177/0002039720962119
2688-4046,1,1,1,2,38,0,40,,10.1002/smsc.202100042
2688-8319,1,1,1,0,23,10,33,,10.1002/2688-8319.12067
2688-8319,1,1,1,5,53,15,73,,10.1002/2688-8319.12107
2688-8319,1,1,1,4,36,3,43,,10.1002/2688-8319.12102
0102-7972 1678-7153,1,1,1,0,36,19,55,,10.1186/s41155-019-0136-1
0013-3264 1820-7375,1,1,1,0,1,0,1,,10.2298/EKA1190103G
2567-3165,1,1,1,0,56,1,57,,10.1002/inf2.12250
2050-6511,1,1,1,1,24,1,26,,10.1186/s40360-018-0241-2
2050-6511,1,1,1,61,0,3,64,,10.1186/s40360-017-0154-5
2050-6511,1,1,1,30,0,3,33,,10.1186/s40360-017-0163-4
2050-6511,1,1,1,15,1,1,17,,10.1186/s40360-017-0148-3
2050-6511,1,1,1,37,0,0,37,,10.1186/s40360-017-0133-x
2213-7467,1,1,1,2,43,9,54,,10.1186/s40323-018-0117-4
2213-7467,1,1,1,6,48,11,65,,10.1186/s40323-021-00189-2
2405-8440,1,1,1,64,0,19,83,,10.1016/j.heliyon.2017.e00379
2405-8440,1,1,1,40,0,1,41,,10.1016/j.heliyon.2017.e00400
2542-5196,1,1,1,35,0,3,38,,10.1016/S2542-5196(17)30082-7
2542-5196,1,1,1,0,5,0,5,,10.1016/S2542-5196(17)30023-2
2542-5196,1,1,1,5,0,1,6,,10.1016/S2542-5196(17)30142-0
2214-1391,1,1,1,7,0,12,19,,10.1016/j.ijans.2015.02.001
2468-2667,1,1,1,4,0,0,4,,10.1016/S2468-2667(17)30014-2
2468-2667,1,1,1,8,0,2,10,,10.1016/S2468-2667(18)30006-9
2084-980X 2300-6676,1,1,1,26,0,21,47,,10.1515/cipms-2017-0022
2084-980X 2300-6676,1,1,1,23,0,3,26,,10.2478/cipms-2020-0031
2084-980X 2300-6676,1,1,1,18,0,1,19,,10.2478/cipms-2020-0033
2084-980X 2300-6676,1,1,1,38,0,4,42,,10.2478/cipms-2020-0034
2084-980X 2300-6676,1,1,1,20,0,0,20,,10.2478/cipms-2020-0038
2084-980X 2300-6676,1,1,1,12,0,5,17,,10.2478/cipms-2020-0040
2084-980X 2300-6676,1,1,1,31,0,10,41,,10.2478/cipms-2021-0023
0717-3458,1,1,1,39,0,11,50,,10.1016/j.ejbt.2015.05.001
0717-3458,1,1,1,15,0,5,20,,10.1016/j.ejbt.2016.01.008
0717-3458,1,1,1,138,0,20,158,,10.1016/j.ejbt.2017.10.012
0717-3458,1,1,1,117,0,15,132,,10.1016/j.ejbt.2016.07.003
0256-4947 0975-4466,1,1,1,25,0,7,32,,10.5144/0256-4947.2016.409
0256-4947 0975-4466,1,1,1,6,0,4,10,,10.5144/0256-4947.2017.42
0256-4947 0975-4466,1,1,1,25,10,12,47,,10.5144/0256-4947.2021.369
0256-4947 0975-4466,1,1,1,13,0,10,23,,10.5144/0256-4947.2021.318
0256-4947 0975-4466,1,1,1,1,41,10,52,,10.5144/0256-4947.2020.321
0256-4947 0975-4466,1,1,1,28,0,5,33,,10.5144/0256-4947.2021.293
0256-4947 0975-4466,1,1,1,5,46,8,59,,10.5144/0256-4947.2021.285
0256-4947 0975-4466,1,1,1,29,0,4,33,,10.5144/0256-4947.2021.376
1516-635X 1806-9061,1,1,1,27,0,12,39,,10.1590/1516-635XSPECIALISSUENutrition-PoultryFeedingAdditives073-086
1516-635X 1806-9061,1,1,1,14,0,16,30,,10.1590/S1516-635X2013000400013
1516-635X 1806-9061,1,1,1,21,0,13,34,,10.1590/S1516-635X2012000100010
1516-635X 1806-9061,1,1,1,25,0,3,28,,10.1590/1806-9061-2016-0319
1516-635X 1806-9061,1,1,1,19,0,10,29,,10.1590/S1516-635X2005000100009
1516-635X 1806-9061,1,1,1,14,0,18,32,,10.1590/S1516-635X2009000200003
1516-635X 1806-9061,1,1,1,26,0,15,41,,10.1590/1806-9061-2019-1014
1516-635X 1806-9061,1,1,1,15,0,3,18,,10.1590/18069061-2015-0052
1516-635X 1806-9061,1,1,1,18,0,5,23,,10.1590/S1516-635X2008000100003
1657-5997 2027-5374,1,1,1,1,22,6,29,,10.5294/aqui.2017.17.4.3
0100-512X,1,1,1,1,0,11,12,,10.1590/S0100-512X2006000100006
0100-512X,1,1,1,0,0,9,9,,10.1590/S0100-512X2008000100012
0100-512X,1,1,1,0,0,16,16,,10.1590/S0100-512X2004000100002
2451-3202 2543-702X,1,1,1,0,4,0,4,,10.4467/2543702XSHS.17.001.7702
2451-3202 2543-702X,1,1,1,1,8,9,18,,10.4467/2543702XSHS.20.016.12572
2451-3202 2543-702X,1,1,1,0,18,49,67,,10.4467/23921749SHS.16.012.6155
1865-035X 1865-0368,1,1,1,40,0,13,53,,10.1007/s12159-015-0123-6
1581-1832,1,1,1,3,0,60,63,,10.1515/orga-2017-0023
1581-1832,1,1,1,57,0,9,66,,10.2478/orga-2021-0006
1581-1832,1,1,1,23,0,18,41,,10.1515/orga-2016-0020
2193-0856 2193-0864,1,1,1,1,0,7,8,,10.5194/gi-6-285-2017
2193-0856 2193-0864,1,1,1,47,0,15,62,,10.5194/gi-5-127-2016
2193-0856 2193-0864,1,1,1,1,0,15,16,,10.5194/gi-5-561-2016
2514-4820,1,1,1,23,0,21,44,,10.5334/joc.43
2514-4820,1,1,1,13,0,13,26,,10.5334/joc.79
0121-8417 2357-4720,1,1,1,10,0,52,62,,10.15446/hys.n34.66652
0121-8417 2357-4720,1,1,1,4,0,45,49,,10.15446/hys.n32.55512
2517-729X,1,1,1,10,7,12,29,,10.1136/gpsych-2020-100347
2517-729X,1,1,1,5,8,0,13,,10.1136/gpsych-2021-100586
2517-729X,1,1,1,15,15,3,33,,10.1136/gpsych-2020-100446
2517-729X,1,1,1,9,9,5,23,,10.1136/gpsych-2021-100524
1980-8585 2237-9843,1,1,1,1,0,24,25,,10.1590/1980-85852503880004305
2304-4977,1,1,1,5,0,21,26,,10.17759/jmfp.2020090409
2673-4117,1,1,1,0,25,6,31,,10.3390/eng2010005
1710-1484 1710-1492,1,1,1,0,36,8,44,,10.1186/s13223-021-00522-9
1710-1484 1710-1492,1,1,1,0,24,4,28,,10.1186/s13223-019-0391-9
1710-1484 1710-1492,1,1,1,82,1,10,93,,10.1186/s13223-020-00460-y
1710-1484 1710-1492,1,1,1,0,15,3,18,,10.1186/s13223-021-00630-6
1710-1484 1710-1492,1,1,1,45,1,3,49,,10.1186/s13223-020-00480-8
1710-1484 1710-1492,1,1,1,2,42,10,54,,10.1186/s13223-019-0377-7
2076-0752,1,1,1,1,7,59,67,,10.3390/arts10010016
2076-0752,1,1,1,0,0,19,19,,10.3390/arts8010030
1335-9096,1,1,1,2,2,116,120,,10.1515/sjps-2015-0014
2086-7050 2528-6013,1,1,1,0,35,47,82,,10.20473/mkp.V33I32020.222-237
2086-7050 2528-6013,1,1,1,0,1,18,19,,10.20473/mkp.V30I42017.418-427
2086-7050 2528-6013,1,1,1,0,21,20,41,,10.20473/mkp.V33I42020.339-351
2086-7050 2528-6013,1,1,1,0,20,26,46,,10.20473/mkp.V33I32020.266-277
2624-599X,1,1,1,0,20,14,34,,10.3390/acoustics3010011
2624-599X,1,1,1,1,23,19,43,,10.3390/acoustics2040039
2624-599X,1,1,1,0,11,18,29,,10.3390/acoustics3020028
0350-8773 2560-3310,1,1,1,87,0,12,99,,10.5937/pramed2102035L
2237-6089 2238-0019,1,1,1,5,0,3,8,,10.1590/2237-6089-2014-0001
2237-6089 2238-0019,1,1,1,10,0,17,27,,10.1590/S2237-60892012000100006
2237-6089 2238-0019,1,1,1,16,0,1,17,,10.1590/2237-6089-2014-1007
2237-6089 2238-0019,1,1,1,21,0,20,41,,10.1590/2237-6089-2014-0043
2237-6089 2238-0019,1,1,1,24,0,13,37,,10.1590/2237-6089-2019-0073
2078-8975 2078-8983,1,1,1,4,0,27,31,,10.21603/2078-8975-2021-23-3-599-612
2078-8975 2078-8983,1,1,1,3,0,25,28,,10.21603/2078-8975-2021-23-3-798-804
2078-8975 2078-8983,1,1,1,14,0,16,30,,10.21603/2078-8975-2021-23-1-143-155
2078-8975 2078-8983,1,1,1,7,0,17,24,,10.21603/2078-8975-2021-23-1-174-182
2078-8975 2078-8983,1,1,1,12,0,14,26,,10.21603/2078-8975-2020-22-2-463-470
2078-8975 2078-8983,1,1,1,3,0,25,28,,10.21603/2078-8975-2020-22-2-387-396
2500-4247 2541-8564,1,1,1,0,1,36,37,,10.22455/2500-4247-2020-5-4-10-37
2376-6808,1,1,1,0,40,10,50,,10.1080/23766808.2018.1429164
1976-8710 2005-0720,1,1,1,0,27,3,30,,10.21053/ceo.2020.02061
1976-8710 2005-0720,1,1,1,0,7,0,7,,10.21053/ceo.2020.02215
1314-2488 1619-0033,1,1,1,0,59,0,59,,10.3897/neobiota.70.64614
1314-2488 1619-0033,1,1,1,14,0,36,50,,10.3897/neobiota.16.3806
2047-9980,1,1,1,1,32,0,33,,10.1161/JAHA.120.020655
2047-9980,1,1,1,0,48,6,54,,10.1161/JAHA.120.017524
2047-9980,1,1,1,0,25,0,25,,10.1161/JAHA.120.020475
2047-9980,1,1,1,1,30,3,34,,10.1161/JAHA.121.021827
2047-9980,1,1,1,0,43,4,47,,10.1161/JAHA.120.019814
2047-9980,1,1,1,0,82,1,83,,10.1161/JAHA.121.023517
2047-9980,1,1,1,1,6,0,7,,10.1161/JAHA.121.023567
2047-9980,1,1,1,0,32,4,36,,10.1161/JAHA.121.022870
2047-9980,1,1,1,1,68,1,70,,10.1161/JAHA.121.023131
2047-9980,1,1,1,0,56,8,64,,10.1161/JAHA.120.020184
2047-9980,1,1,1,0,22,9,31,,10.1161/JAHA.121.020396
2047-9980,1,1,1,0,43,0,43,,10.1161/JAHA.121.022567
2047-9980,1,1,1,0,23,1,24,,10.1161/JAHA.121.023129
2047-9980,1,1,1,0,5,0,5,,10.1161/JAHA.121.023428
2047-9980,1,1,1,0,34,4,38,,10.1161/JAHA.121.022617
2047-9980,1,1,1,0,23,3,26,,10.1161/JAHA.121.021090
2047-9980,1,1,1,0,40,2,42,,10.1161/JAHA.121.022060
2047-9980,1,1,1,0,21,1,22,,10.1161/JAHA.121.021970
2047-9980,1,1,1,0,8,1,9,,10.1161/JAHA.121.021614
2047-9980,1,1,1,2,52,7,61,,10.1161/JAHA.121.021140
2047-9980,1,1,1,1,68,2,71,,10.1161/JAHA.120.019918
2047-9980,1,1,1,0,51,12,63,,10.1161/JAHA.121.021047
2541-8297 2542-2421,1,1,1,0,0,11,11,,10.22455/2541-8297-2020-16-278-306
2541-8297 2542-2421,1,1,1,0,1,35,36,,10.22455/2541-8297-2020-18-109-151
2541-8297 2542-2421,1,1,1,0,0,6,6,,10.22455/2541-8297-2020-18-300-311
2541-8297 2542-2421,1,1,1,1,0,17,18,,10.22455/2541-8297-2020-18-355-364
2541-8297 2542-2421,1,1,1,0,0,11,11,,10.22455/2541-8297-2020-17-237-264
2541-8297 2542-2421,1,1,1,0,1,17,18,,10.22455/2541-8297-2020-17-292-303
2029-6991 2029-7009,1,1,1,0,8,26,34,,10.3846/gac.2021.12492
1815-1434 1815-1442,1,1,1,9,22,1,32,,10.26442/18151434.2021.2.200869
1815-1434 1815-1442,1,1,1,0,10,0,10,,10.26442/18151434.2021.1.200745
1815-1434 1815-1442,1,1,1,24,5,11,40,,10.26442/18151434.2020.4.200568
1815-1434 1815-1442,1,1,1,0,11,0,11,,10.26442/18151434.2020.2.200121
1815-1434 1815-1442,1,1,1,0,11,0,11,,10.26442/18151434.2020.3.200339
2264-7228,1,1,1,0,9,0,9,,10.4000/dms.175
2264-7228,1,1,1,0,8,0,8,,10.4000/dms.137
2264-7228,1,1,1,0,3,0,3,,10.4000/dms.1474
2264-7228,1,1,1,0,2,0,2,,10.4000/dms.2691
2264-7228,1,1,1,0,5,0,5,,10.4000/dms.337
2264-7228,1,1,1,0,15,0,15,,10.4000/dms.6028
1681-7710 2518-1696,1,1,1,40,0,1,41,,10.30748/soi.2020.160.09
2633-1055,1,1,1,0,15,0,15,,10.1177/26331055211058687
2633-1055,1,1,1,0,69,8,77,,10.1177/2633105520988854
0860-6161 1734-4948,1,1,1,4,0,60,64,,10.1515/rehab-2015-0057
1947-5705 1947-5713,1,1,1,0,4,0,4,,10.1080/19475705.2015.1050608
1947-5705 1947-5713,1,1,1,2,18,6,26,,10.1080/19475705.2016.1155502
1947-5705 1947-5713,1,1,1,1,13,17,31,,10.1080/19475705.2016.1181677
1947-5705 1947-5713,1,1,1,0,60,10,70,,10.1080/19475705.2016.1222313
1947-5705 1947-5713,1,1,1,0,9,20,29,,10.1080/19475705.2018.1530305
1947-5705 1947-5713,1,1,1,0,32,9,41,,10.1080/19475705.2017.1284160
1947-5705 1947-5713,1,1,1,0,51,22,73,,10.1080/19475705.2017.1318794
1947-5705 1947-5713,1,1,1,0,40,12,52,,10.1080/19475705.2017.1337652
2673-3145,1,1,1,1,10,4,15,,10.3389/fpos.2021.627982
2673-3145,1,1,1,1,21,12,34,,10.3389/fpos.2021.743252
2673-3145,1,1,1,12,68,35,115,,10.3389/fpos.2021.696105
0123-5931 2256-5450,1,1,1,0,0,19,19,,10.15446/lthc.v21n1.74875
1178-6388,1,1,1,0,50,2,52,,10.1177/11786388211006447
1178-6388,1,1,1,1,119,12,132,,10.1177/11786388211058559
2398-9238,1,1,1,1,61,3,65,,10.1002/edm2.190
2398-9238,1,1,1,0,26,3,29,,10.1002/edm2.210
2398-9238,1,1,1,0,16,1,17,,10.1002/edm2.62
2398-9238,1,1,1,0,15,1,16,,10.1002/edm2.126
2398-9238,1,1,1,0,36,0,36,,10.1002/edm2.90
2398-9238,1,1,1,0,9,2,11,,10.1002/edm2.221
2398-9238,1,1,1,0,22,0,22,,10.1002/edm2.208
2398-9238,1,1,1,0,50,6,56,,10.1002/edm2.171
2661-3352 2661-3344,1,1,1,0,15,6,21,,10.1142/S2661335220500045
2661-3352 2661-3344,1,1,1,0,7,1,8,,10.1142/S2661335220500070
2661-3352 2661-3344,1,1,1,0,14,16,30,,10.1142/S2661335220500069
2471-254X,1,1,1,0,28,3,31,,10.1002/hep4.1571
2471-254X,1,1,1,0,35,5,40,,10.1002/hep4.1564
2471-254X,1,1,1,0,158,13,171,,10.1002/hep4.1823
2471-254X,1,1,1,0,43,0,43,,10.1002/hep4.1787
2471-254X,1,1,1,0,44,3,47,,10.1002/hep4.1785
2471-254X,1,1,1,0,47,2,49,,10.1002/hep4.1362
2471-254X,1,1,1,0,37,2,39,,10.1002/hep4.1639
2471-254X,1,1,1,0,28,0,28,,10.1002/hep4.1643
2471-254X,1,1,1,0,76,2,78,,10.1002/hep4.1618
2471-254X,1,1,1,0,24,0,24,,10.1002/hep4.1621
2471-254X,1,1,1,0,49,4,53,,10.1002/hep4.1656
2471-254X,1,1,1,0,3,2,5,,10.1002/hep4.1664
1728-2667 2079-908X,1,1,1,1,2,24,27,,10.17721/1728-2667.2015/174-9/7
1728-2667 2079-908X,1,1,1,0,5,9,14,,10.17721/1728-2667.2015/177-12/3
1728-2667 2079-908X,1,1,1,0,5,11,16,,10.17721/1728-2667.2016/180-3/8
1728-2667 2079-908X,1,1,1,1,1,26,28,,10.17721/1728-2667.2016/178-1/1
1728-2667 2079-908X,1,1,1,0,1,24,25,,10.17721/1728-2667.2016/185-8/3
1728-2667 2079-908X,1,1,1,2,0,10,12,,10.17721/1728-2667.2013/145-4/9
1728-2667 2079-908X,1,1,1,1,0,11,12,,10.17721/1728-2667.2013/146-5/6
2287-2728 2287-285X,1,1,1,8,0,6,14,,10.3350/cmh.2013.19.4.376
2287-2728 2287-285X,1,1,1,8,0,0,8,,10.3350/cmh.2015.21.1.22
2287-2728 2287-285X,1,1,1,8,0,12,20,,10.3350/cmh.2014.20.2.208
2287-2728 2287-285X,1,1,1,0,38,2,40,,10.3350/cmh.2021.0067
2287-2728 2287-285X,1,1,1,0,72,5,77,,10.3350/cmh.2020.0234
2287-2728 2287-285X,1,1,1,0,5,2,7,,10.3350/cmh.2021.0171
2287-2728 2287-285X,1,1,1,0,24,5,29,,10.3350/cmh.2019.0006
2645-3525 2645-3452,1,1,1,1,12,8,21,,10.5812/sdme.62391
2645-3525 2645-3452,1,1,1,0,11,4,15,,10.5812/sdme.82695
2645-3525 2645-3452,1,1,1,0,4,5,9,,10.5812/sdme.84664
2645-3525 2645-3452,1,1,1,0,3,17,20,,10.5812/sdme.85677
2645-3525 2645-3452,1,1,1,0,9,19,28,,10.5812/sdme.86701
2645-3525 2645-3452,1,1,1,0,9,1,10,,10.5812/sdme.97918
2645-3525 2645-3452,1,1,1,9,15,8,32,,10.5812/sdme.59227
0121-5051 2248-6968,1,1,1,3,6,13,22,,10.15446/innovar.v24n53.43922
0121-5051 2248-6968,1,1,1,52,0,68,120,,10.15446/innovar.v25n56.48987
0121-5051 2248-6968,1,1,1,3,17,30,50,,10.15446/innovar.v29n73.78026
0121-5051 2248-6968,1,1,1,37,0,11,48,,10.15446/innovar.v25n55.47231
0121-5051 2248-6968,1,1,1,5,31,52,88,,10.15446/innovar.v30n76.85193
2213-1795 2213-1809,1,1,1,1,72,7,80,,10.18528/gii160006
2213-1795 2213-1809,1,1,1,1,26,1,28,,10.18528/gii150032
2213-1795 2213-1809,1,1,1,0,19,1,20,,10.18528/gii160031
1981-8122 2178-2547,1,1,1,132,0,45,177,,10.1590/S1981-81222013000300013
1981-8122 2178-2547,1,1,1,0,0,5,5,,10.1590/S1981-81222011000100014
1981-8122 2178-2547,1,1,1,0,0,61,61,,10.1590/1981.81222016000100015
0103-7307 1980-6248,1,1,1,2,0,13,15,,10.1590/S0103-73072013000300007
0103-7307 1980-6248,1,1,1,8,0,39,47,,10.1590/S0103-73072008000100016
2571-8800,1,1,1,0,26,7,33,,10.3390/j3030022
2306-5710,1,1,1,0,44,3,47,,10.3390/beverages7020016
2306-5710,1,1,1,0,26,7,33,,10.3390/beverages4020045
2306-5710,1,1,1,1,22,5,28,,10.3390/beverages3010014
2306-5710,1,1,1,2,35,11,48,,10.3390/beverages1040273
2306-5710,1,1,1,1,86,9,96,,10.3390/beverages5020036
1598-2254 2093-9280,1,1,1,32,0,1,33,,10.5423/PPJ.OA.11.2015.0250
1598-2254 2093-9280,1,1,1,11,1,5,17,,10.5423/PPJ.NT.10.2013.0099
1598-2254 2093-9280,1,1,1,25,0,11,36,,10.5423/PPJ.OA.05.2015.0091
1598-2254 2093-9280,1,1,1,0,27,9,36,,10.5423/PPJ.OA.09.2020.0176
1598-2254 2093-9280,1,1,1,0,12,3,15,,10.5423/PPJ.NT.03.2020.0050
1598-2254 2093-9280,1,1,1,0,25,7,32,,10.5423/PPJ.OA.02.2018.0031
1598-2254 2093-9280,1,1,1,0,20,10,30,,10.5423/PPJ.OA.11.2018.0278
2765-1606 2765-1614,1,1,1,0,27,2,29,,10.5090/jcs.20.102
2765-1606 2765-1614,1,1,1,0,59,1,60,,10.5090/jcs.21.027
2765-1606 2765-1614,1,1,1,0,8,1,9,,10.5090/jcs.20.151
2765-1606 2765-1614,1,1,1,0,7,1,8,,10.5090/jcs.21.016
2765-1606 2765-1614,1,1,1,0,1,0,1,,10.5090/jcs.16.123e1
2515-9321,1,1,1,0,55,3,58,,10.12688/aasopenres.13074.3
2050-4322 2050-4330,1,1,1,1,93,31,125,,10.3310/pgfar09040
2050-4322 2050-4330,1,1,1,2,82,21,105,,10.3310/pgfar09150
2333-3936,1,1,1,0,10,1,11,,10.1177/23333936211006397
2365-6271,1,1,1,0,8,0,8,,10.1186/s41205-021-00126-4
2365-6271,1,1,1,0,1,0,1,,10.1186/s41205-020-00088-z
1742-6405,1,1,1,44,2,12,58,,10.1186/s12981-021-00395-3
1742-6405,1,1,1,20,0,42,62,,10.1186/s12981-021-00415-2
2042-0188 2042-0196,1,1,1,0,1,0,1,,10.1177/20420188211058582
2073-4379,1,1,1,0,3,14,17,,10.26565/2073-4379-2020-36-11
2310-9513,1,1,1,0,2,19,21,,10.26565/2310-9513-2019-10-22
2310-9513,1,1,1,0,1,8,9,,10.26565/2310-9513-2019-10-23
2310-9513,1,1,1,1,0,10,11,,10.26565/2310-9513-2020-11-05
1189-3788 1920-7344,1,1,1,0,4,0,4,,10.4000/communication.14808
1189-3788 1920-7344,1,1,1,0,37,0,37,,10.4000/communication.14397
1189-3788 1920-7344,1,1,1,0,43,0,43,,10.4000/communication.14433
1189-3788 1920-7344,1,1,1,0,8,0,8,,10.4000/communication.14253
1762-6153,1,1,1,0,4,0,4,,10.4000/lisa.13552
1762-6153,1,1,1,0,2,0,2,,10.4000/lisa.13412
2673-3153,1,1,1,0,28,7,35,,10.3389/frph.2021.756405
2673-3153,1,1,1,1,19,16,36,,10.3389/frph.2021.665653
2673-3218,1,1,1,9,62,16,87,,10.3389/fagro.2021.609536
2673-3218,1,1,1,0,32,4,36,,10.3389/fagro.2020.573860
2673-3218,1,1,1,6,219,10,235,,10.3389/fagro.2021.781027
2673-3218,1,1,1,2,40,11,53,,10.3389/fagro.2021.782686
2673-3218,1,1,1,11,407,29,447,,10.3389/fagro.2021.648694
0220-5610 2271-6149,1,1,1,0,2,0,2,,10.4000/cve.9580
0220-5610 2271-6149,1,1,1,0,3,0,3,,10.4000/cve.8282
0220-5610 2271-6149,1,1,1,0,2,0,2,,10.4000/cve.8257
0220-5610 2271-6149,1,1,1,0,7,0,7,,10.4000/cve.3151
0220-5610 2271-6149,1,1,1,0,4,0,4,,10.4000/cve.10190
0220-5610 2271-6149,1,1,1,0,12,0,12,,10.4000/cve.9505
0220-5610 2271-6149,1,1,1,0,1,0,1,,10.4000/cve.8823
0220-5610 2271-6149,1,1,1,0,5,0,5,,10.4000/cve.5114
2095-5162 2049-9957,1,1,1,0,22,12,34,,10.1186/s40249-019-0620-y
2095-5162 2049-9957,1,1,1,0,69,12,81,,10.1186/s40249-019-0597-6
2111-5028,1,1,1,0,16,0,16,,10.4000/anthropologiesante.9930
2111-5028,1,1,1,0,19,0,19,,10.4000/anthropologiesante.9987
2111-5028,1,1,1,0,10,0,10,,10.4000/anthropologiesante.6059
2399-5351,1,1,1,5,5,2,12,,10.1136/ihj-2020-000043
1110-8630 2090-2441,1,1,1,0,18,8,26,,10.1186/s43042-019-0037-y
1110-8630 2090-2441,1,1,1,0,39,2,41,,10.1186/s43042-020-00104-1
1110-8630 2090-2441,1,1,1,0,66,3,69,,10.1186/s43042-020-00059-3
1110-8630 2090-2441,1,1,1,0,40,1,41,,10.1186/s43042-021-00209-1
2049-3002,1,1,1,1,28,2,31,,10.1186/s40170-021-00244-x
2049-3002,1,1,1,1,76,0,77,,10.1186/s40170-020-00234-5
1931-7573 1556-276X,1,1,1,0,52,0,52,,10.1186/s11671-020-3255-9
1931-7573 1556-276X,1,1,1,1,26,1,28,,10.1186/s11671-019-3204-7
1931-7573 1556-276X,1,1,1,0,47,0,47,,10.1186/s11671-019-3188-3
1931-7573 1556-276X,1,1,1,1,40,1,42,,10.1186/s11671-019-2934-x
1931-7573 1556-276X,1,1,1,1,29,3,33,,10.1186/s11671-019-3025-8
1931-7573 1556-276X,1,1,1,1,51,2,54,,10.1186/s11671-019-2884-3
1478-7547,1,1,1,2,20,43,65,,10.1186/s12962-020-0199-y
1478-7547,1,1,1,6,25,16,47,,10.1186/s12962-020-00210-2
1478-7547,1,1,1,0,16,0,16,,10.1186/s12962-020-00224-w
2661-801X,1,1,1,0,48,3,51,,10.1186/s13065-021-00734-5
1756-6614,1,1,1,0,8,1,9,,10.1186/s13044-020-0076-y
1756-6614,1,1,1,48,0,5,53,,10.1186/s13044-021-00118-w
2391-5471,1,1,1,0,0,75,75,,10.1515/phys-2015-0034
2284-6417,1,1,1,2,4,30,36,,10.1515/rjdnmd-2016-0029
2059-0628,1,1,1,2,17,6,25,,10.1186/s41077-018-0062-9
1687-806X 1687-8078,1,1,1,1,11,13,25,,10.1155/2021/9298305
0253-7176 0975-1564,1,1,1,0,3,1,4,,10.1177/02537176211046525
2056-7529,1,1,1,1,7,19,27,,10.1186/s40900-018-0122-2
2056-7529,1,1,1,0,23,1,24,,10.1186/s40900-021-00261-6
2056-7529,1,1,1,1,22,6,29,,10.1186/s40900-021-00291-0
2056-7529,1,1,1,0,14,24,38,,10.1186/s40900-021-00292-z
2265-4224,1,1,1,16,0,6,22,,10.1051/mfreview/2018007
2265-4224,1,1,1,21,0,20,41,,10.1051/mfreview/2021026
2213-4530,1,1,1,154,0,10,164,,10.1016/j.fshw.2017.03.001
2055-0340 2055-0359,1,1,1,0,30,11,41,,10.1080/20550340.2017.1306337
2055-0340 2055-0359,1,1,1,0,10,5,15,,10.1080/20550340.2019.1680514
2055-0340 2055-0359,1,1,1,1,49,28,78,,10.1080/20550340.2018.1500099
2055-0340 2055-0359,1,1,1,5,42,30,77,,10.1080/20550340.2020.1750329
2055-0340 2055-0359,1,1,1,0,18,10,28,,10.1080/20550340.2017.1341125
2055-0340 2055-0359,1,1,1,0,29,1,30,,10.1080/20550340.2021.1967650
2055-0340 2055-0359,1,1,1,0,4,1,5,,10.1080/20550340.2019.1598049
2055-0340 2055-0359,1,1,1,1,25,10,36,,10.1080/20550340.2018.1439688
2055-0340 2055-0359,1,1,1,1,19,17,37,,10.1080/20550340.2020.1768348
2364-5504,1,1,1,4,0,4,8,,10.1515/cdbme-2018-0008
2410-390X,1,1,1,0,15,5,20,,10.3390/instruments2030018
2410-390X,1,1,1,0,75,11,86,,10.3390/instruments5010008
2075-4698,1,1,1,0,18,12,30,,10.3390/soc8020034
2075-4698,1,1,1,0,39,29,68,,10.3390/soc8020021
2075-4698,1,1,1,2,43,22,67,,10.3390/soc10040101
2075-4698,1,1,1,0,16,35,51,,10.3390/soc11020063
2075-4698,1,1,1,0,32,16,48,,10.3390/soc11020031
2000-7426,1,1,1,0,12,18,30,,10.3384/rela.2000-7426.rela0105
2000-7426,1,1,1,0,19,35,54,,10.3384/rela.2000-7426.ojs1346
2000-7426,1,1,1,0,19,30,49,,10.3384/rela.2000-7426.ojs1479
2352-3441,1,1,1,67,0,14,81,,10.1016/j.artd.2016.12.002
2262-5534,1,1,1,0,2,0,2,,10.4000/peme.5025
2314-7172,1,1,1,5,21,11,37,,10.1186/s43067-021-00031-0
2314-7172,1,1,1,5,15,6,26,,10.1186/s43067-020-00017-4
2314-7172,1,1,1,16,18,31,65,,10.1186/s43067-021-00028-9
2046-0481,1,1,1,0,37,8,45,,10.1186/s13620-021-00189-z
2046-0481,1,1,1,0,5,3,8,,10.1186/s13620-017-0090-0
2229-0443,1,1,1,4,32,20,56,,10.1186/s40468-021-00119-4
2314-4386 2314-4394,1,1,1,0,39,30,69,,10.1155/2016/1712370
1748-3018 1748-3026,1,1,1,0,9,4,13,,10.1177/1748302621999582
1748-3018 1748-3026,1,1,1,0,19,6,25,,10.1177/1748302621999621
2468-2659,1,1,1,80,0,29,109,,10.1016/j.pld.2017.09.001
2468-2659,1,1,1,20,0,11,31,,10.1016/j.pld.2016.09.004
2468-2659,1,1,1,30,0,5,35,,10.1016/j.pld.2016.03.001
2468-2659,1,1,1,13,0,18,31,,10.1016/j.pld.2016.08.002
2468-2659,1,1,1,56,0,40,96,,10.1016/j.pld.2016.11.004
2213-9567,1,1,1,7,0,4,11,,10.1016/j.jma.2015.10.001
2213-9567,1,1,1,42,0,3,45,,10.1016/j.jma.2016.05.001
2213-9567,1,1,1,22,0,3,25,,10.1016/j.jma.2016.06.001
2213-9567,1,1,1,29,0,0,29,,10.1016/j.jma.2015.08.007
2352-8540,1,1,1,1,0,27,28,,10.1016/j.ngib.2017.05.003
2352-8540,1,1,1,5,0,31,36,,10.1016/j.ngib.2017.07.006
2352-8540,1,1,1,3,0,21,24,,10.1016/j.ngib.2016.05.006
2352-8540,1,1,1,2,0,11,13,,10.1016/j.ngib.2016.02.002
2352-8540,1,1,1,8,0,18,26,,10.1016/j.ngib.2017.08.004
2352-8540,1,1,1,0,0,16,16,,10.1016/j.ngib.2014.10.011
2075-4442,1,1,1,1,5,15,21,,10.3390/lubricants9110108
2075-4442,1,1,1,0,31,6,37,,10.3390/lubricants9110111
2075-4442,1,1,1,0,11,9,20,,10.3390/lubricants6030081
0102-6720,1,1,1,38,0,3,41,,10.1590/S0102-67202009000400009
0102-6720,1,1,1,2,0,8,10,,10.1590/S0102-67202011000100017
0102-6720,1,1,1,27,0,5,32,,10.1590/S0102-67202011000100008
0102-6720,1,1,1,14,0,4,18,,10.1590/S0102-67202009000200005
0102-6720,1,1,1,6,0,1,7,,10.1590/S0102-67202009000400010
0101-2800 2175-8239,1,1,1,7,0,0,7,,10.1590/2175-8239-jbn-2020-0035
0101-2800 2175-8239,1,1,1,11,0,1,12,,10.1590/2175-8239-jbn-2018-0081
1674-9278,1,1,1,0,0,25,25,,10.1016/j.accre.2017.03.002
1674-9278,1,1,1,7,0,2,9,,10.3724/SP.J.1248.2014.051
1674-9278,1,1,1,12,0,9,21,,10.1016/j.accre.2015.09.003
1674-9278,1,1,1,4,0,8,12,,10.1016/j.accre.2015.09.008
2095-9885 2468-0141,1,1,1,5,0,20,25,,10.1016/j.hpj.2017.02.001
2095-9885 2468-0141,1,1,1,23,0,9,32,,10.1016/j.hpj.2017.07.008
2586-5595 2586-5552,1,1,1,0,37,11,48,,10.15758/ajk.2021.23.4.3
2090-598X 2090-5998,1,1,1,0,1,0,1,,10.1016/j.aju.2018.05.001
2090-598X 2090-5998,1,1,1,1,11,1,13,,10.1016/j.aju.2017.01.004
2090-598X 2090-5998,1,1,1,1,31,1,33,,10.1016/j.aju.2017.02.002
2090-598X 2090-5998,1,1,1,1,29,0,30,,10.1016/j.aju.2017.01.005
2090-598X 2090-5998,1,1,1,0,28,2,30,,10.1016/j.aju.2017.06.002
2090-598X 2090-5998,1,1,1,0,19,0,19,,10.1016/j.aju.2017.06.001
2090-598X 2090-5998,1,1,1,0,10,2,12,,10.1016/j.aju.2016.12.002
2090-598X 2090-5998,1,1,1,0,13,2,15,,10.1016/j.aju.2016.10.003
2090-598X 2090-5998,1,1,1,1,25,7,33,,10.1016/j.aju.2017.03.005
2090-598X 2090-5998,1,1,1,0,19,1,20,,10.1016/j.aju.2016.12.003
2090-598X 2090-5998,1,1,1,0,8,1,9,,10.1016/j.aju.2017.03.003
2499-4553,1,1,1,0,8,0,8,,10.4000/ijcol.508
2499-4553,1,1,1,0,17,0,17,,10.4000/ijcol.453
2499-4553,1,1,1,0,4,0,4,,10.4000/ijcol.728
2499-4553,1,1,1,0,10,0,10,,10.4000/ijcol.311
2499-4553,1,1,1,0,7,0,7,,10.4000/ijcol.502
2499-4553,1,1,1,0,4,0,4,,10.4000/ijcol.331
2499-4553,1,1,1,0,6,0,6,,10.4000/ijcol.483
2499-4553,1,1,1,0,3,0,3,,10.4000/ijcol.553
2499-4553,1,1,1,0,4,0,4,,10.4000/ijcol.298
2499-4553,1,1,1,0,3,0,3,,10.4000/ijcol.441
1687-7578 1687-7586,1,1,1,1,3,0,4,,10.1155/2012/801641
2372-7705,1,1,1,42,0,7,49,,10.1038/mto.2014.2
0101-3157 1809-4538,1,1,1,2,0,32,34,,10.1590/0101-31572015v36n04a06
0101-3157 1809-4538,1,1,1,4,0,18,22,,10.1590/S0101-31572010000200003
0101-3157 1809-4538,1,1,1,2,0,13,15,,10.1590/S0101-31572005000200004
0101-3157 1809-4538,1,1,1,11,0,22,33,,10.1590/S0101-31572009000400009
0101-3157 1809-4538,1,1,1,5,0,24,29,,10.1590/0101-31572018v38n02a02
0101-3157 1809-4538,1,1,1,7,0,13,20,,10.1590/0101-31572018v38n02a07
0369-1527 2466-5525,1,1,1,10,0,2,12,,10.5937/mp72-27624
0369-1527 2466-5525,1,1,1,41,0,9,50,,10.5937/mp72-31846
0369-1527 2466-5525,1,1,1,15,0,1,16,,10.5937/mp72-32451
1805-3580,1,1,1,4,0,73,77,,10.1515/cjot-2016-0009
2504-5660 2504-5679,1,1,1,17,0,3,20,,10.21303/2504-5679.2021.002194
2504-5660 2504-5679,1,1,1,15,0,6,21,,10.21303/2504-5679.2021.002183
2504-5660 2504-5679,1,1,1,23,0,4,27,,10.21303/2504-5679.2021.002174
2504-5660 2504-5679,1,1,1,0,9,11,20,,10.21303/2504-5679.2020.001312
2504-5660 2504-5679,1,1,1,2,20,7,29,,10.21303/2504-5679.2020.001423
2504-5660 2504-5679,1,1,1,0,10,13,23,,10.21303/2504-5679.2020.001317
2474-7394,1,1,1,0,50,3,53,,10.1525/collabra.150
2474-7394,1,1,1,0,24,7,31,,10.1525/collabra.186
2225-1146,1,1,1,3,72,13,88,,10.3390/econometrics8040044
2225-1146,1,1,1,0,20,17,37,,10.3390/econometrics4040041
2192-113X,1,1,1,1,10,8,19,,10.1186/s13677-019-0141-z
2192-113X,1,1,1,2,25,11,38,,10.1186/s13677-020-00199-2
2661-8974,1,1,1,7,23,0,30,,10.1186/s43014-020-00041-x
1664-2376 1664-2384,1,1,1,0,41,30,71,,10.1186/s13358-020-00210-y
2683-2232 2594-178X,1,1,1,0,12,35,47,,10.22201/iib.2594178xe.2020.2.77
2051-6673,1,1,1,0,55,5,60,,10.1186/s40479-019-0116-1
1300-686X 2297-8747,1,1,1,0,10,14,24,,10.3390/mca23040061
1300-686X 2297-8747,1,1,1,0,17,9,26,,10.3390/mca24030084
1300-686X 2297-8747,1,1,1,7,59,12,78,,10.3390/mca24030083
1300-686X 2297-8747,1,1,1,1,6,15,22,,10.3390/mca23020031
2632-8925,1,1,1,0,4,2,6,,10.1049/qtc2.12002
1936-6426 1936-6434,1,1,1,0,1,2,3,,10.1186/s12052-020-00139-3
1936-6426 1936-6434,1,1,1,30,60,32,122,,10.1186/s12052-021-00158-8
1936-6426 1936-6434,1,1,1,4,46,16,66,,10.1186/s12052-021-00148-w
2692-9384,1,1,1,1,39,2,42,,10.1002/jcv2.12040
1963-1197,1,1,1,0,13,0,13,,10.4000/echogeo.22404
1963-1197,1,1,1,0,12,0,12,,10.4000/echogeo.22179
2333-8326 2333-8334,1,1,1,0,7,0,7,,10.3934/energy.2015.4.798
2333-8326 2333-8334,1,1,1,0,10,0,10,,10.3934/energy.2015.4.699
2333-8326 2333-8334,1,1,1,0,13,39,52,,10.3934/energy.2018.1.146
2333-8326 2333-8334,1,1,1,13,0,19,32,,10.3934/energy.2021010
2333-8326 2333-8334,1,1,1,0,3,9,12,,10.3934/energy.2020.4.652
1472-6882,1,1,1,0,49,12,61,,10.1186/s12906-019-2764-5
1472-6882,1,1,1,31,2,14,47,,10.1186/s12906-017-2001-z
1472-6882,1,1,1,3,20,26,49,,10.1186/s12906-018-2140-x
1472-6882,1,1,1,23,0,7,30,,10.1186/s12906-017-1871-4
1472-6882,1,1,1,17,0,3,20,,10.1186/s12906-017-1759-3
1472-6882,1,1,1,19,0,0,19,,10.1186/s12906-017-1990-y
2055-7426,1,1,1,0,4,15,19,,10.1186/s40834-019-0103-3
2055-7426,1,1,1,1,3,16,20,,10.1186/s40834-019-0087-z
1957-7788,1,1,1,0,12,0,12,,10.4000/metropoles.7939
1957-7788,1,1,1,0,1,0,1,,10.4000/metropoles.8153
1957-7788,1,1,1,0,10,0,10,,10.4000/metropoles.7814
2090-1836 2090-1844,1,1,1,4,8,3,15,,10.1155/2011/936240
1992-2655,1,1,1,0,7,0,7,,10.4000/sociologies.16955
1992-2655,1,1,1,0,8,0,8,,10.4000/sociologies.17379
1969-6124,1,1,1,0,2,0,2,,10.4000/paysage.22193
1969-6124,1,1,1,0,6,0,6,,10.4000/paysage.14305
1969-6124,1,1,1,0,3,0,3,,10.4000/paysage.6111
1969-6124,1,1,1,0,1,0,1,,10.4000/paysage.14948
1969-6124,1,1,1,0,5,0,5,,10.4000/paysage.12042
1969-6124,1,1,1,0,1,0,1,,10.4000/paysage.16533
1969-6124,1,1,1,0,1,0,1,,10.4000/paysage.17594
1969-6124,1,1,1,0,5,0,5,,10.4000/paysage.18250
1969-6124,1,1,1,0,1,0,1,,10.4000/paysage.451
1969-6124,1,1,1,0,4,0,4,,10.4000/paysage.11898
1969-6124,1,1,1,0,2,0,2,,10.4000/paysage.5004
1969-6124,1,1,1,0,2,0,2,,10.4000/paysage.12838
1969-6124,1,1,1,0,6,0,6,,10.4000/paysage.12281
2055-5660,1,1,1,20,1,9,30,,10.1186/s40813-017-0067-0
2055-5660,1,1,1,0,76,8,84,,10.1186/s40813-021-00241-y
2405-5816 2405-6561,1,1,1,38,0,14,52,,10.1016/j.petlm.2015.07.011
2405-5816 2405-6561,1,1,1,17,0,5,22,,10.1016/j.petlm.2016.11.009
2405-5816 2405-6561,1,1,1,6,0,97,103,,10.1016/j.petlm.2015.11.001
2405-5816 2405-6561,1,1,1,19,0,1,20,,10.1016/j.petlm.2015.07.007
1210-8812 2199-6202,1,1,1,57,0,5,62,,10.2478/mgr-2020-0019
2214-4420,1,1,1,4,0,1,5,,10.1016/j.eucr.2016.08.003
2214-4420,1,1,1,1,0,2,3,,10.1016/j.eucr.2017.07.003
2214-4420,1,1,1,6,0,5,11,,10.1016/j.eucr.2015.03.005
2085-3297 2355-9179,1,1,1,8,180,2,190,,10.18585/inabj.v5i3.64
2029-6320 2029-6339,1,1,1,1,0,8,9,,10.3846/coactivity.2006.08
1338-6905 1339-004X,1,1,1,13,0,35,48,,10.2478/nbec-2018-0018
1763-0061 1963-1812,1,1,1,0,8,0,8,,10.4000/traces.4751
1763-0061 1963-1812,1,1,1,0,4,0,4,,10.4000/traces.4216
1110-0621,1,1,1,4,0,11,15,,10.1016/j.ejpe.2015.11.003
1110-0621,1,1,1,7,0,24,31,,10.1016/j.ejpe.2014.08.005
2090-7141 2090-715X,1,1,1,1,10,6,17,,10.1155/2018/9575281
2090-7141 2090-715X,1,1,1,1,2,0,3,,10.1155/2012/815374
2379-5077,1,1,1,0,31,3,34,,10.1128/mSystems.00100-17
2379-5077,1,1,1,0,23,2,25,,10.1128/mSystems.00142-16
2379-5077,1,1,1,0,41,2,43,,10.1128/mSystems.00046-17
2379-5077,1,1,1,0,27,2,29,,10.1128/mSystems.00169-17
2379-5077,1,1,1,0,21,0,21,,10.1128/mSystems.00050-17
2379-5077,1,1,1,1,40,4,45,,10.1128/mSystems.00039-15
2379-5077,1,1,1,0,46,1,47,,10.1128/mSystems.00001-18
2379-5077,1,1,1,0,86,0,86,,10.1128/mSystems.00524-19
2379-5077,1,1,1,1,58,11,70,,10.1128/mSystems.00264-19
2379-5077,1,1,1,1,110,8,119,,10.1128/mSystems.00498-19
2379-5077,1,1,1,0,26,0,26,,10.1128/mSystems.00023-18
2379-5077,1,1,1,0,41,6,47,,10.1128/mSystems.00136-17
2379-5077,1,1,1,0,27,1,28,,10.1128/mSystems.00021-18
2379-5077,1,1,1,0,41,4,45,,10.1128/mSystems.00020-18
2379-5077,1,1,1,0,37,0,37,,10.1128/mSystems.00407-19
2379-5077,1,1,1,0,99,4,103,,10.1128/mSystems.00702-19
2379-5077,1,1,1,0,86,3,89,,10.1128/mSystems.00631-19
2379-5077,1,1,1,0,17,2,19,,10.1128/mSystems.00202-17
2379-5077,1,1,1,0,40,3,43,,10.1128/mSystems.00024-18
2379-5077,1,1,1,0,94,0,94,,10.1128/mSystems.00170-18
2379-5077,1,1,1,1,53,1,55,,10.1128/mSystems.00225-18
2379-5077,1,1,1,0,62,3,65,,10.1128/mSystems.00240-18
2379-5077,1,1,1,0,58,4,62,,10.1128/mSystems.00004-19
2379-5077,1,1,1,0,70,0,70,,10.1128/mSystems.00578-19
2379-5077,1,1,1,0,41,0,41,,10.1128/mSystems.00226-20
2379-5077,1,1,1,0,50,2,52,,10.1128/mSystems.00857-19
2379-5077,1,1,1,0,94,2,96,,10.1128/mSystems.00438-20
2379-5077,1,1,1,1,61,3,65,,10.1128/mSystems.00502-20
2379-5077,1,1,1,0,8,0,8,,10.1128/mSystems.00976-20
2379-5077,1,1,1,1,35,0,36,,10.1128/mSystems.00323-20
2379-5077,1,1,1,1,94,8,103,,10.1128/mSystems.00815-20
2379-5077,1,1,1,0,68,2,70,,10.1128/mSystems.01007-20
2379-5077,1,1,1,0,76,3,79,,10.1128/mSystems.00745-20
2379-5077,1,1,1,0,78,2,80,,10.1128/mSystems.00846-20
2379-5077,1,1,1,0,73,11,84,,10.1128/mSystems.00423-19
2379-5077,1,1,1,0,58,2,60,,10.1128/mSystems.00561-20
2379-5077,1,1,1,0,29,1,30,,10.1128/mSystems.00360-21
2379-5077,1,1,1,0,128,5,133,,10.1128/mSystems.00786-20
2379-5077,1,1,1,4,34,5,43,,10.1128/mSystems.01191-20
2379-5077,1,1,1,0,52,4,56,,10.1128/mSystems.00773-20
2379-5077,1,1,1,0,35,0,35,,10.1128/mSystems.00943-20
2379-5077,1,1,1,0,29,0,29,,10.1128/mSystems.00905-20
2379-5077,1,1,1,0,42,0,42,,10.1128/mSystems.01129-20
2379-5077,1,1,1,0,17,0,17,,10.1128/mSystems.00362-19
2379-5077,1,1,1,2,30,0,32,,10.1128/mSystems.00261-19
2379-5077,1,1,1,0,46,0,46,,10.1128/mSystems.00186-19
2379-5077,1,1,1,0,48,0,48,,10.1128/mSystems.00770-19
2379-5077,1,1,1,0,14,0,14,,10.1128/mSystems.00114-19
2379-5077,1,1,1,1,46,11,58,,10.1128/mSystems.00258-20
2379-5077,1,1,1,0,64,1,65,,10.1128/mSystems.00002-20
2379-5077,1,1,1,0,59,10,69,,10.1128/mSystems.00298-20
2379-5077,1,1,1,2,80,7,89,,10.1128/mSystems.00471-20
2379-5077,1,1,1,1,55,0,56,,10.1128/mSystems.00047-20
2379-5077,1,1,1,0,60,4,64,,10.1128/mSystems.00848-20
2379-5077,1,1,1,0,65,6,71,,10.1128/mSystems.00044-18
2379-5077,1,1,1,0,98,0,98,,10.1128/mSystems.00214-18
2379-5077,1,1,1,0,78,1,79,,10.1128/mSystems.00206-18
2379-5077,1,1,1,0,81,1,82,,10.1128/mSystems.00131-18
2379-5077,1,1,1,0,86,1,87,,10.1128/mSystems.00150-18
2379-5077,1,1,1,1,78,1,80,,10.1128/mSystems.00026-19
2379-5077,1,1,1,1,46,1,48,,10.1128/mSystems.00392-19
2379-5077,1,1,1,0,50,6,56,,10.1128/mSystems.00097-18
2379-5077,1,1,1,0,65,1,66,,10.1128/mSystems.00317-18
2379-5077,1,1,1,0,98,1,99,,10.1128/mSystems.00217-18
2379-5077,1,1,1,2,68,1,71,,10.1128/mSystems.00157-18
2379-5077,1,1,1,0,9,1,10,,10.1128/mSystems.00086-18
2379-5077,1,1,1,0,86,1,87,,10.1128/mSystems.00323-19
2379-5077,1,1,1,1,7,0,8,,10.1128/mSystems.00467-19
2379-5077,1,1,1,0,61,1,62,,10.1128/mSystems.00257-19
2379-5077,1,1,1,0,27,3,30,,10.1128/mSystems.00452-19
2379-5077,1,1,1,0,70,4,74,,10.1128/mSystems.00897-19
2379-5077,1,1,1,0,21,0,21,,10.1128/mSystems.00115-19
2379-5077,1,1,1,1,14,0,15,,10.1128/mSystems.00106-19
2379-5077,1,1,1,1,68,0,69,,10.1128/mSystems.00658-19
2379-5077,1,1,1,0,59,4,63,,10.1128/mSystems.00640-20
2379-5077,1,1,1,0,59,0,59,,10.1128/mSystems.00267-20
2379-5077,1,1,1,0,58,1,59,,10.1128/mSystems.00645-20
2379-5077,1,1,1,0,78,2,80,,10.1128/mSystems.00565-20
2379-5077,1,1,1,1,71,0,72,,10.1128/mSystems.00358-20
2379-5077,1,1,1,0,29,2,31,,10.1128/mSystems.00189-20
2379-5077,1,1,1,1,47,4,52,,10.1128/mSystems.00230-19
2379-5077,1,1,1,0,49,5,54,,10.1128/mSystems.00357-19
2379-5077,1,1,1,0,66,1,67,,10.1128/mSystems.00620-19
2379-5077,1,1,1,0,16,0,16,,10.1128/mSystems.00187-17
2379-5077,1,1,1,0,20,1,21,,10.1128/mSystems.00166-17
2379-5077,1,1,1,0,77,4,81,,10.1128/mSystems.00162-20
2379-5077,1,1,1,0,64,2,66,,10.1128/mSystems.00261-20
2379-5077,1,1,1,0,29,4,33,,10.1128/mSystems.00077-20
2379-5077,1,1,1,0,67,3,70,,10.1128/mSystems.00145-20
2379-5077,1,1,1,2,24,3,29,,10.1128/mSystems.00777-19
2379-5077,1,1,1,0,166,7,173,,10.1128/mSystems.00495-19
2379-5077,1,1,1,0,49,2,51,,10.1128/mSystems.00224-20
2379-5077,1,1,1,0,67,1,68,,10.1128/mSystems.00462-20
2379-5077,1,1,1,0,36,0,36,,10.1128/mSystems.00337-20
2379-5077,1,1,1,0,52,8,60,,10.1128/mSystems.00626-20
2379-5077,1,1,1,3,19,0,22,,10.1128/mSystems.00453-20
2379-5077,1,1,1,1,97,8,106,,10.1128/mSystems.00202-16
2379-5077,1,1,1,0,66,4,70,,10.1128/mSystems.00004-17
2379-5077,1,1,1,0,41,2,43,,10.1128/mSystems.00003-15
2379-5077,1,1,1,1,58,0,59,,10.1128/mSystems.00124-16
2379-5077,1,1,1,0,48,1,49,,10.1128/mSystems.00192-16
2379-5077,1,1,1,0,8,0,8,,10.1128/mSystems.00050-16
2379-5077,1,1,1,0,59,1,60,,10.1128/mSystems.00043-17
2379-5077,1,1,1,2,85,4,91,,10.1128/mSystems.00117-16
2379-5077,1,1,1,0,51,1,52,,10.1128/mSystems.00084-18
2379-5077,1,1,1,0,61,0,61,,10.1128/mSystems.00135-17
2379-5077,1,1,1,0,91,2,93,,10.1128/mSystems.00057-18
2379-5077,1,1,1,0,54,0,54,,10.1128/mSystems.00554-19
2379-5077,1,1,1,2,89,3,94,,10.1128/mSystems.00093-19
2379-5077,1,1,1,0,28,0,28,,10.1128/mSystems.00413-19
2379-5077,1,1,1,0,44,2,46,,10.1128/mSystems.00213-18
2379-5077,1,1,1,0,10,0,10,,10.1128/mSystems.01256-20
2379-5077,1,1,1,0,56,1,57,,10.1128/mSystems.00591-20
2379-5077,1,1,1,1,69,3,73,,10.1128/mSystems.00770-20
2379-5077,1,1,1,0,7,0,7,,10.1128/mSystems.00234-21
2379-5077,1,1,1,0,80,0,80,,10.1128/mSystems.01337-20
2379-5077,1,1,1,0,75,1,76,,10.1128/mSystems.01148-20
1479-7364,1,1,1,0,125,0,125,,10.1186/1479-7364-3-4-332
1479-7364,1,1,1,0,40,0,40,,10.1186/s40246-019-0245-z
1479-7364,1,1,1,1,128,6,135,,10.1186/s40246-019-0252-0
1479-7364,1,1,1,0,27,0,27,,10.1186/s40246-021-00332-5
2078-1547,1,1,1,7,18,18,43,,10.3390/challe3020278
1994-2060 1997-003X,1,1,1,0,14,13,27,,10.1080/19942060.2017.1279079
1994-2060 1997-003X,1,1,1,2,40,22,64,,10.1080/19942060.2020.1748114
1994-2060 1997-003X,1,1,1,0,19,16,35,,10.1080/19942060.2019.1658228
1994-2060 1997-003X,1,1,1,8,27,1,36,,10.1080/19942060.2020.1761453
1994-2060 1997-003X,1,1,1,0,29,7,36,,10.1080/19942060.2020.1816494
2107-0199,1,1,1,0,7,0,7,,10.4000/mondesanciens.360
1743-8977,1,1,1,2,176,2,180,,10.1186/s12989-020-00391-x
1743-8977,1,1,1,4,72,1,77,,10.1186/s12989-019-0297-1
2045-4015,1,1,1,0,2,1,3,,10.1186/s13584-020-00421-1
2045-4015,1,1,1,1,23,6,30,,10.1186/s13584-018-0256-6
1301-3718 2458-8342,1,1,1,9,0,17,26,,10.30964/auebfd.440349
2391-5420,1,1,1,66,0,10,76,,10.1515/chem-2016-0017
2391-5420,1,1,1,36,0,10,46,,10.1515/chem-2020-0040
2391-5420,1,1,1,62,0,16,78,,10.1515/chem-2020-0147
1618-7229,1,1,1,16,0,3,19,,10.1515/epoly-2020-0045
1618-7229,1,1,1,25,0,0,25,,10.1515/epoly-2020-0009
1618-7229,1,1,1,25,0,0,25,,10.1515/epoly-2020-0044
1618-7229,1,1,1,33,0,0,33,,10.1515/epoly-2020-0034
1618-7229,1,1,1,20,0,0,20,,10.1515/epoly-2020-0008
2157-6998 2157-7005,1,1,1,15,0,1,16,,10.1055/s-0040-1715162
2451-8654,1,1,1,15,0,1,16,,10.1016/j.conctc.2017.11.011
2451-8654,1,1,1,5,0,7,12,,10.1016/j.conctc.2018.01.003
0121-215X 2256-5442,1,1,1,6,0,33,39,,10.15446/rcdg.v22n1.36309
0121-215X 2256-5442,1,1,1,15,0,37,52,,10.15446/rcdg.v20n1.23069
0121-215X 2256-5442,1,1,1,0,27,14,41,,10.15446/rcdg.v24n2.50211
0121-215X 2256-5442,1,1,1,2,0,32,34,,10.15446/rcdg.n18.13018
0121-215X 2256-5442,1,1,1,2,0,24,26,,10.15446/rcdg.n18.13023
0121-215X 2256-5442,1,1,1,46,0,54,100,,10.15446/rcdg.n19.16835
0121-215X 2256-5442,1,1,1,2,0,20,22,,10.15446/rcdg.v20n2.27181
0121-215X 2256-5442,1,1,1,0,0,20,20,,10.15446/rcdg.v20n2.27185
0121-215X 2256-5442,1,1,1,8,0,21,29,,10.15446/rcdg.v20n2.27184
2352-7714,1,1,1,29,0,5,34,,10.1016/j.onehlt.2017.08.001
2410-3896,1,1,1,0,76,3,79,,10.3390/condmat6010012
2410-3896,1,1,1,0,26,0,26,,10.3390/condmat3010001
2226-4787,1,1,1,0,25,4,29,,10.3390/pharmacy9010048
2226-4787,1,1,1,0,6,18,24,,10.3390/pharmacy5020024
2226-4787,1,1,1,2,26,18,46,,10.3390/pharmacy7030130
2226-4787,1,1,1,2,20,3,25,,10.3390/pharmacy7030131
2226-4787,1,1,1,0,16,8,24,,10.3390/pharmacy8020053
2226-4787,1,1,1,0,24,1,25,,10.3390/pharmacy8030167
2226-4787,1,1,1,0,12,4,16,,10.3390/pharmacy9020111
2226-4787,1,1,1,0,16,19,35,,10.3390/pharmacy9010055
2619-0311 2712-8512,1,1,1,0,0,6,6,,10.22455/2619-0311-2021-2-116-127
2619-0311 2712-8512,1,1,1,1,1,9,11,,10.22455/2619-0311-2021-1-244-254
2619-0311 2712-8512,1,1,1,0,1,15,16,,10.22455/2619-0311-2020-9-242-259
2619-0311 2712-8512,1,1,1,0,0,1,1,,10.22455/2619-0311-2021-4-18-23
2074-5885,1,1,1,0,0,10,10,,10.17759/psyedu.2015070411
2074-5885,1,1,1,1,0,12,13,,10.17759/psyedu.2017090315
2074-5885,1,1,1,0,0,8,8,,10.17759/psyedu.2017090114
2632-6140,1,1,1,9,2,0,11,,10.1136/bmjno-2021-000142
2632-6140,1,1,1,9,14,2,25,,10.1136/bmjno-2019-000030
2632-6140,1,1,1,11,8,5,24,,10.1136/bmjno-2020-000065
2307-6127,1,1,1,2,0,13,15,,10.23951/2307-6127-2020-4-37-46
2307-6127,1,1,1,0,0,16,16,,10.23951/2307-6127-2021-2-100-107
2307-6127,1,1,1,2,0,11,13,,10.23951/2307-6127-2021-2-135-143
2307-6127,1,1,1,0,0,10,10,,10.23951/2307-6127-2021-6-95-102
2307-6127,1,1,1,21,0,15,36,,10.23951/2307-6127-2021-6-225-235
2287-8882,1,1,1,23,0,1,24,,10.1016/j.prnil.2015.03.002
2090-1224 2090-1232,1,1,1,28,0,1,29,,10.1016/j.jare.2015.02.002
2090-1224 2090-1232,1,1,1,23,0,15,38,,10.1016/j.jare.2014.06.008
2090-1224 2090-1232,1,1,1,18,0,15,33,,10.1016/j.jare.2014.02.005
2090-1224 2090-1232,1,1,1,16,0,4,20,,10.1016/j.jare.2017.03.001
2642-2514,1,1,1,5,17,4,26,,10.1002/prm2.12029
1756-8277 1756-8285,1,1,1,0,26,5,31,,10.1177/17568277211055979
1753-4259 1753-4267,1,1,1,6,98,4,108,,10.1177/17534259211051364
1753-4259 1753-4267,1,1,1,0,37,9,46,,10.1177/1753425921994190
1753-4259 1753-4267,1,1,1,0,24,1,25,,10.1177/1753425921994906
2234-8972,1,1,1,0,1,2,3,,10.1080/22348972.2017.1345198
1738-3544 2288-1662,1,1,1,0,11,45,56,,10.15324/kjcls.2021.53.1.105
0100-8587 1984-0438,1,1,1,7,0,29,36,,10.1590/0100-85872016v36n2cap05
0100-8587 1984-0438,1,1,1,2,0,20,22,,10.1590/0100-85872018v38n3cap03
0100-8587 1984-0438,1,1,1,6,0,35,41,,10.1590/0100-85872018v38n3cap07
0100-8587 1984-0438,1,1,1,1,0,22,23,,10.1590/S0100-85872007000200009
2214-6628,1,1,1,38,0,1,39,,10.1016/j.cpb.2015.02.001
2257-0543 2425-231X,1,1,1,0,15,0,15,,10.4000/bresils.8111
2257-0543 2425-231X,1,1,1,0,10,0,10,,10.4000/bresils.7586
0715-3570 1710-7377,1,1,1,0,3,0,3,,10.4000/interventionseconomiques.10394
0715-3570 1710-7377,1,1,1,0,20,0,20,,10.4000/interventionseconomiques.3960
0715-3570 1710-7377,1,1,1,0,1,0,1,,10.4000/interventionseconomiques.966
0715-3570 1710-7377,1,1,1,0,7,0,7,,10.4000/interventionseconomiques.14725
1961-9510,1,1,1,0,19,0,19,,10.4000/ticetsociete.5413
1961-9510,1,1,1,0,16,0,16,,10.4000/ticetsociete.5999
2372-0352,1,1,1,0,8,1,9,,10.3934/environsci.2020025
2572-9241,1,1,1,10,0,1,11,,10.1097/HS9.0000000000000494
2572-9241,1,1,1,80,0,4,84,,10.1097/HS9.0000000000000536
2572-9241,1,1,1,2,0,0,2,,10.1097/HS9.0000000000000012
2572-9241,1,1,1,40,0,2,42,,10.1097/HS9.0000000000000233
2572-9241,1,1,1,48,0,2,50,,10.1097/HS9.0000000000000312
2572-9241,1,1,1,3,0,0,3,,10.1097/HS9.0000000000000323
2352-9067,1,1,1,11,0,0,11,,10.1016/j.ijcha.2016.03.007
2352-9067,1,1,1,14,0,2,16,,10.1016/j.ijcha.2016.05.014
2279-9028 2279-9036,1,1,1,17,0,23,40,,10.4081/jphr.2017.917
0128-1976 2289-4365,1,1,1,0,0,18,18,,10.1108/IJIF-01-2018-0005
2296-9705,1,1,1,0,16,0,16,,10.1159/000507424
2296-9403 2296-9365,1,1,1,0,0,87,87,,10.1159/000512805
2296-9403 2296-9365,1,1,1,0,0,12,12,,10.1159/000512292
2504-110X,1,1,1,0,15,0,15,,10.1159/000513222
2341-4545 2387-1954,1,1,1,0,5,0,5,,10.1159/000514010
2341-4545 2387-1954,1,1,1,0,3,0,3,,10.1159/000514779
2341-4545 2387-1954,1,1,1,0,9,0,9,,10.1159/000514784
2341-4545 2387-1954,1,1,1,0,57,0,57,,10.1159/000499678
2688-1152,1,1,1,0,47,5,52,,10.1002/emp2.12380
2688-1152,1,1,1,1,17,4,22,,10.1002/emp2.12345
2688-1152,1,1,1,1,8,2,11,,10.1002/emp2.12354
2688-1152,1,1,1,0,11,3,14,,10.1002/emp2.12336
2688-1152,1,1,1,0,3,0,3,,10.1002/emp2.12327
2688-1152,1,1,1,2,6,2,10,,10.1002/emp2.12095
2688-1152,1,1,1,10,6,11,27,,10.1002/emp2.12117
2688-1152,1,1,1,0,4,0,4,,10.1002/emp2.12344
2688-1152,1,1,1,0,2,0,2,,10.1002/emp2.12374
2688-1152,1,1,1,0,3,0,3,,10.1002/emp2.12365
1983-4195,1,1,1,1,0,20,21,,10.1590/S1983-41952013000300005
1983-4195,1,1,1,0,0,17,17,,10.1590/S1983-41952012000400006
1983-4195,1,1,1,0,0,12,12,,10.1590/S1983-41952014000300008
2200-6133,1,1,1,1,13,5,19,,10.15172/pneu.2015.6/542
2200-6133,1,1,1,2,14,3,19,,10.1186/s41479-021-00091-w
2573-0134,1,1,1,0,11,5,16,,10.3934/QFE.2017.3.320
1681-276X 2415-8798,1,1,1,10,0,8,18,,10.11603/2415-8798.2019.2.10267
2064-9940,1,1,1,0,25,18,43,,10.14232/JENY.2015.1.4
0300-3604 1573-9058,1,1,1,0,71,2,73,,10.32615/ps.2020.063
0300-3604 1573-9058,1,1,1,0,50,1,51,,10.32615/ps.2019.044
0300-3604 1573-9058,1,1,1,0,31,10,41,,10.32615/ps.2019.007
0300-3604 1573-9058,1,1,1,0,44,3,47,,10.32615/ps.2019.110
2454-6798 2455-4618,1,1,1,15,0,10,25,,10.1055/s-0041-1740106
2451-9936,1,1,1,16,0,3,19,,10.1016/j.ajoc.2016.12.015
2451-9936,1,1,1,15,0,0,15,,10.1016/j.ajoc.2016.05.005
2451-9936,1,1,1,16,0,1,17,,10.1016/j.ajoc.2016.06.008
2466-4774,1,1,1,12,0,5,17,,10.2478/contagri-2018-0010
2709-4715,1,1,1,8,33,7,48,,doi:10.46471/gigabyte.2
2709-4715,1,1,1,61,0,18,79,,10.46471/gigabyte.19
0353-9008 2683-5797,1,1,1,2,0,34,36,,10.5937/bastina31-30520
0353-9008 2683-5797,1,1,1,1,0,28,29,,10.5937/bastina31-31133
0353-9008 2683-5797,1,1,1,0,0,10,10,,10.5937/bastina31-32589
0353-9008 2683-5797,1,1,1,0,0,14,14,,10.5937/bastina31-33019
0353-9008 2683-5797,1,1,1,18,0,11,29,,10.5937/bastina31-32445
2217-9739 2560-3353,1,1,1,1,0,2,3,,10.5937/intrev2102139D
2217-9739 2560-3353,1,1,1,6,0,10,16,,10.5937/intrev2102047M
2217-9739 2560-3353,1,1,1,10,0,9,19,,10.5937/intrev2102052
2217-9739 2560-3353,1,1,1,6,0,8,14,,10.5937/intrev2102101A
2502-7816 2503-524X,1,1,1,0,6,7,13,,10.33369/joall.v4i2.7759
2502-7816 2503-524X,1,1,1,0,15,12,27,,10.33369/joall.v5i1.7644
2502-7816 2503-524X,1,1,1,0,11,12,23,,10.33369/joall.v5i2.10753
2502-7816 2503-524X,1,1,1,0,10,19,29,,10.33369/joall.v6i1.11130
2502-7816 2503-524X,1,1,1,0,8,11,19,,10.33369/joall.v6i1.11462
2502-7816 2503-524X,1,1,1,0,11,21,32,,10.33369/joall.v6i1.13642
2502-7816 2503-524X,1,1,1,0,6,7,13,,10.33369/joall.v6i1.11608
0352-5317 1849-0840,1,1,1,0,2,0,2,,10.25234/pv/5644
0352-5317 1849-0840,1,1,1,0,5,38,43,,10.25234/pv/13884
0352-5317 1849-0840,1,1,1,0,7,52,59,,10.25234/pv/11003
0352-5317 1849-0840,1,1,1,0,14,33,47,,10.25234/pv/10187
2520-6338 2617-4006,1,1,1,1,0,30,31,,10.33581/2520-6338-2020-4-7-19
2520-6338 2617-4006,1,1,1,0,0,2,2,,10.33581/2520-6338-2021-1-90-98
2520-6338 2617-4006,1,1,1,0,0,35,35,,10.33581/2520-6338-2020-3-44-53
1451-4117 1821-3197,1,1,1,16,0,7,23,,10.5937/jaes0-30037
1451-4117 1821-3197,1,1,1,28,0,18,46,,10.5937/jaes0-29201
1451-4117 1821-3197,1,1,1,7,0,10,17,,10.5937/jaes0-31438
1451-4117 1821-3197,1,1,1,12,0,10,22,,10.5937/jaes0-27267
1451-4117 1821-3197,1,1,1,10,0,28,38,,10.5937/jaes0-31315
1451-4117 1821-3197,1,1,1,12,0,5,17,,10.5937/jaes0-29180
1451-4117 1821-3197,1,1,1,11,0,11,22,,10.5937/jaes0-28385
1451-4117 1821-3197,1,1,1,21,0,3,24,,10.5937/jaes0-29059
1687-6962 1687-6970,1,1,1,5,7,5,17,,10.1155/2012/923904
2515-2270,1,1,1,22,0,7,29,,10.5334/paah.65
1664-5464,1,1,1,0,31,0,31,,10.1159/000511397
1664-5464,1,1,1,0,44,0,44,,10.1159/000486331
1530-261X,1,1,1,0,26,4,30,,10.1002/asl.1065
1530-261X,1,1,1,1,30,5,36,,10.1002/asl.935
1664-3607 1664-3615,1,1,1,0,17,3,20,,10.1142/S1664360720500162
1807-7692,1,1,1,18,0,28,46,,10.1590/1807-7692bar2016140120
1807-7692,1,1,1,27,0,36,63,,10.1590/1807-7692bar2018180003
2587-2648,1,1,1,1,1,1,3,,10.31197/atnaa.554239
2587-2648,1,1,1,13,0,5,18,,10.31197/atnaa.573903
2571-631X,1,1,1,0,40,6,46,,10.3390/vibration3040032
2571-631X,1,1,1,0,32,8,40,,10.3390/vibration4020021
2688-4844,1,1,1,1,14,1,16,,10.1089/WHR.2020.0085
1662-4025 1662-4033,1,1,1,0,0,28,28,,10.1159/000519269
1662-4025 1662-4033,1,1,1,0,26,0,26,,10.1159/000520718
1110-4929 2357-0008,1,1,1,0,0,9,9,,10.1016/j.wsj.2013.12.008
1110-4929 2357-0008,1,1,1,0,33,43,76,,10.1016/j.wsj.2017.03.002
1110-4929 2357-0008,1,1,1,0,22,5,27,,10.1016/j.wsj.2014.12.002
1110-4929 2357-0008,1,1,1,0,0,4,4,,10.1016/j.wsj.2017.07.002
1110-4929 2357-0008,1,1,1,0,1,7,8,,10.1016/j.wsj.2017.10.002
1110-4929 2357-0008,1,1,1,0,20,11,31,,10.1016/j.wsj.2016.12.001
1110-4929 2357-0008,1,1,1,3,31,28,62,,10.1016/j.wsj.2017.10.001
2451-912X,1,1,1,47,0,7,54,,10.1016/j.sesci.2017.12.003
2211-3797,1,1,1,23,0,4,27,,10.1016/j.rinp.2015.11.003
2269-5281 2425-1682,1,1,1,0,2,0,2,,10.4000/eac.1231
2269-5281 2425-1682,1,1,1,0,6,0,6,,10.4000/eac.1097
2490-3329 2303-7954,1,1,1,10,0,2,12,,10.5937/scriptamed52-34128
0004-1963 2217-8767,1,1,1,69,0,9,78,,10.5937/arhfarm71-32480
0004-1963 2217-8767,1,1,1,21,0,5,26,,10.5937/arhfarm71-32284
0004-1963 2217-8767,1,1,1,8,0,7,15,,10.5937/arhfarm71-32093
0354-9542 2560-3140,1,1,1,40,0,0,40,,10.5937/AASer2151011C
2466-541X 2466-5452,1,1,1,5,0,37,42,,10.5937/cm15-24096
2334-8666 2560-3108,1,1,1,3,0,47,50,,10.5937/ZbAkU2109046M
2334-8666 2560-3108,1,1,1,0,0,34,34,,10.5937/ZbAkU2109187T
2334-8666 2560-3108,1,1,1,2,0,26,28,,10.5937/ZbAkU2109271D
2334-8666 2560-3108,1,1,1,1,0,9,10,,10.5937/ZbAkU2109174B
1452-0133 2334-7074,1,1,1,52,0,8,60,,10.5937/ZbDght2101014L
0974-7168 2320-7094,1,1,1,1,0,24,25,,10.4103/ijrh.ijrh_33_18
0974-7168 2320-7094,1,1,1,73,0,36,109,,10.4103/ijrh.ijrh_106_20
0974-7168 2320-7094,1,1,1,13,0,15,28,,10.4103/ijrh.ijrh_19_20
1647-0737,1,1,1,0,3,0,3,,10.4000/eces.466
1647-0737,1,1,1,0,13,0,13,,10.4000/eces.664
1647-0737,1,1,1,0,9,0,9,,10.4000/eces.390
1647-0737,1,1,1,0,4,0,4,,10.4000/eces.233
1647-0737,1,1,1,0,2,0,2,,10.4000/eces.203
1647-0737,1,1,1,0,1,0,1,,10.4000/eces.1314
2580-1163 2580-9776,1,1,1,0,30,12,42,,10.20473/amnt.v4i4.2020.307-312
2580-1163 2580-9776,1,1,1,0,2,11,13,,10.20473/amnt.v1i1.2017.14-21
0354-7132 2217-3994,1,1,1,7,0,5,12,,10.5937/opmed2102011L
0354-7132 2217-3994,1,1,1,13,0,5,18,,10.5937/opmed27-32733
0354-2904 2560-3337,1,1,1,17,0,0,17,,10.5937/podrad2138047Q
0354-2904 2560-3337,1,1,1,14,0,2,16,,10.5937/podrad2138015N
1944-3277,1,1,1,0,30,9,39,,10.1186/s40793-017-0242-6
1944-3277,1,1,1,0,37,4,41,,10.1186/s40793-018-0314-2
1451-2092 2406-128X,1,1,1,21,0,4,25,,10.5937/fme2104842C
1451-2092 2406-128X,1,1,1,19,0,5,24,,10.5937/fme2103749S
1451-2092 2406-128X,1,1,1,25,0,22,47,,10.5937/fme2104867R
1451-2092 2406-128X,1,1,1,26,0,30,56,,10.5937/fme2104876M
1451-2092 2406-128X,1,1,1,49,0,2,51,,10.5937/fme2104908M
1451-2092 2406-128X,1,1,1,20,0,10,30,,10.5937/fme2103673S
1451-2092 2406-128X,1,1,1,21,0,4,25,,10.5937/fme2103711M
1451-2092 2406-128X,1,1,1,26,0,4,30,,10.5937/fme2103740A
2217-5458 2620-0228,1,1,1,7,0,8,15,,10.5937/etp2102017K
2217-5458 2620-0228,1,1,1,30,0,6,36,,10.5937/etp2102038S
2217-5458 2620-0228,1,1,1,9,0,16,25,,10.5937/etp2103064M
2000-8686,1,1,1,0,4,1,5,,10.1080/20008686.2017.1323532
0104-0219 2318-9312,1,1,1,0,19,16,35,,10.14450/2318-9312.v32.e4.a2020.pp353-365
0104-0219 2318-9312,1,1,1,0,9,16,25,,10.14450/2318-9312.v25.e2.a2013.pp71-75
0104-0219 2318-9312,1,1,1,1,13,9,23,,10.14450/2318-9312.v28.e1.a2016.pp40-46
2302-707X 2540-8828,1,1,1,0,8,19,27,,10.20473/jbk.v10i1.2021.68-75
2302-707X 2540-8828,1,1,1,0,19,15,34,,10.20473/jbk.v10i1.2021.94-104
1687-4285,1,1,1,2,0,12,14,,10.1016/j.ejar.2014.07.005
1913-4126,1,1,1,0,7,4,11,,10.20982/tqmp.11.3.p139
1913-4126,1,1,1,6,7,7,20,,10.20982/tqmp.16.4.p281
1339-0015,1,1,1,14,0,4,18,,10.2478/jamsi-2018-0010
2084-8838,1,1,1,0,1,26,27,,10.1515/ami-2016-0005
2084-8838,1,1,1,15,0,56,71,,10.1515/ami-2018-0006
2084-8838,1,1,1,0,0,17,17,,10.2478/ami-2014-0003
2251-9920,1,1,1,1,18,3,22,,10.15171/jcs.2019.007
2251-9920,1,1,1,3,29,6,38,,10.15171/jcs.2018.006
2251-9920,1,1,1,1,36,4,41,,10.34172/jcs.2021.010
1751-8644 1751-8652,1,1,1,0,34,1,35,,10.1049/cth2.12201
1751-8644 1751-8652,1,1,1,3,21,8,32,,10.1049/cth2.12211
0033-4952 2421-5848,1,1,1,0,4,0,4,,10.4000/qds.971
0033-4952 2421-5848,1,1,1,0,9,0,9,,10.4000/qds.1011
0033-4952 2421-5848,1,1,1,0,14,0,14,,10.4000/qds.810
2071-1395 2398-7812,1,1,1,4,0,33,37,,10.1108/APJIE-04-2017-022
2221-7185 2658-5707,1,1,1,0,23,0,23,,10.26442//22217185.2021.2.200859
2221-7185 2658-5707,1,1,1,0,2,0,2,,10.26442/22217185.2020.2.200266
2221-7185 2658-5707,1,1,1,0,18,0,18,,10.26442/22217185.2020.3.200408
2221-7185 2658-5707,1,1,1,0,9,0,9,,10.26442/22217185.2020.4.200565
2221-7185 2658-5707,1,1,1,7,2,9,18,,10.26442/22217185.2021.1.200767
2221-7185 2658-5707,1,1,1,0,28,8,36,,10.17816/22217185.2021.3.201027
2699-9404,1,1,1,41,0,10,51,,10.1055/s-0041-1728689
2699-9404,1,1,1,17,1,1,19,,10.1055/s-0041-1732481
2699-9404,1,1,1,54,2,1,57,,10.1055/s-0041-1735590
2673-611X,1,1,1,6,44,18,68,,10.3389/fcosc.2021.752953
2673-611X,1,1,1,1,81,17,99,,10.3389/fcosc.2021.752213
2052-4439,1,1,1,1,3,4,8,,10.1136/bmjresp-2021-001120
2052-4439,1,1,1,7,9,11,27,,10.1136/bmjresp-2021-000980
1757-4676 1757-4684,1,1,1,0,54,2,56,,10.15252/emmm.202115098
1757-4676 1757-4684,1,1,1,0,80,2,82,,10.15252/emmm.202114544
1757-4676 1757-4684,1,1,1,0,46,3,49,,10.15252/emmm.202013787
2673-561X,1,1,1,28,17,24,69,,10.3389/fpain.2021.770511
2673-561X,1,1,1,29,30,11,70,,10.3389/fpain.2021.750523
2673-561X,1,1,1,0,24,1,25,,10.3389/fpain.2021.692250
2397-7604,1,1,1,22,0,34,56,,10.1108/JRIT-08-2017-0015
1751-9659 1751-9667,1,1,1,8,30,21,59,,10.1049/ipr2.12343
1751-9659 1751-9667,1,1,1,2,19,6,27,,10.1049/ipr2.12348
1751-9659 1751-9667,1,1,1,12,38,7,57,,10.1049/ipr2.12341
1751-9659 1751-9667,1,1,1,16,3,16,35,,10.1049/ipr2.12342
1751-9659 1751-9667,1,1,1,1,32,9,42,,10.1049/ipr2.12345
2432-3853,1,1,1,21,0,0,21,,10.23922/jarc.2016-013
2432-3853,1,1,1,10,0,0,10,,10.23922/jarc.2020-077
2300-9896 2658-1442,1,1,1,1,11,8,20,,10.19206/CE-141583
2300-9896 2658-1442,1,1,1,0,19,2,21,,10.19206/CE-141541
2300-9896 2658-1442,1,1,1,0,6,5,11,,10.19206/CE-141263
2300-9896 2658-1442,1,1,1,0,6,2,8,,10.19206/CE-141312
2300-9896 2658-1442,1,1,1,0,5,6,11,,10.19206/CE-141740
2300-9896 2658-1442,1,1,1,1,1,9,11,,10.19206/CE-141738
1687-8787 1687-8795,1,1,1,41,79,48,168,,10.1155/2013/876132
2271-6092,1,1,1,0,12,0,12,,10.4000/edso.1178
2271-6092,1,1,1,0,6,0,6,,10.4000/edso.1282
2271-6092,1,1,1,0,5,0,5,,10.4000/edso.270
2271-6092,1,1,1,0,3,0,3,,10.4000/edso.6250
2271-6092,1,1,1,0,14,0,14,,10.4000/edso.11782
2271-6092,1,1,1,0,2,0,2,,10.4000/edso.14798
1752-1416 1752-1424,1,1,1,0,1,0,1,,10.1049/rpg2.12283
1752-1416 1752-1424,1,1,1,0,19,5,24,,10.1049/rpg2.12306
1752-1416 1752-1424,1,1,1,2,39,0,41,,10.1049/rpg2.12307
1752-1416 1752-1424,1,1,1,3,28,10,41,,10.1049/rpg2.12295
1752-1416 1752-1424,1,1,1,8,46,5,59,,10.1049/rpg2.12272
2193-8253 2193-6536,1,1,1,1,52,0,53,,10.1007/s40120-019-00164-5
2193-8253 2193-6536,1,1,1,8,64,3,75,,10.1007/s40120-019-00166-3
1687-4137 2090-5394,1,1,1,0,9,4,13,,10.1186/s43159-019-0006-8
1687-4137 2090-5394,1,1,1,0,36,8,44,,10.1186/s43159-021-00130-7
1687-4137 2090-5394,1,1,1,0,12,7,19,,10.1186/s43159-021-00133-4
2665-1513 2711-0532,1,1,1,0,8,18,26,,10.37979/afb.2020v3n2.74
2665-1513 2711-0532,1,1,1,1,12,8,21,,10.37979/afb.2020v3n2.68
2228-6497,1,1,1,0,11,1,12,,10.34172/hpp.2020.44
2228-6497,1,1,1,1,7,5,13,,10.34172/hpp.2020.26
2228-6497,1,1,1,0,1,3,4,,10.15171/hpp.2017.20
2228-6497,1,1,1,1,33,8,42,,10.34172/hpp.2020.23
2313-2396 2313-6693,1,1,1,1,6,5,12,,https://doi.org/10.26565/2313-6693-2020-40-06
2313-2396 2313-6693,1,1,1,0,4,3,7,,https://doi.org/10.26565/2313-6693-2020-40-15
2199-1006,1,1,1,1,10,0,11,,10.14293/S2199-1006.1.SOR-LIFE.A67837.v1
2199-1006,1,1,1,16,83,98,197,,10.14293/S2199-1006.1.SOR-LIFE.ALTCE1.v1
2397-0928,1,1,1,0,0,52,52,,10.14324/111.444.ljcs.2019v34.009
2397-0928,1,1,1,4,0,90,94,,10.14324/111.444.ljcs.2019v34.004
2397-0928,1,1,1,2,0,18,20,,10.14324/111.444.ljcs.2018v33.005
2397-0928,1,1,1,1,0,37,38,,10.14324/111.444.ljcs.2019v34.007
2515-7086,1,1,1,1,0,6,7,,10.14324/FEJ.03.1.03
2515-7086,1,1,1,1,0,9,10,,10.14324/FEJ.03.2.02
2051-5804,1,1,1,2,0,20,22,,10.14324/111.444.ijsp.2014.v3.1.006
2051-5804,1,1,1,8,0,35,43,,10.14324/111.444.ijsp.2017.v6.1.002
2051-5804,1,1,1,1,0,10,11,,10.14324/111.444.ijsp.2015.v4.1.008
2051-5804,1,1,1,9,0,30,39,,10.14324/111.444.ijsp.2015.v4.1.013
2051-5804,1,1,1,0,0,24,24,,10.14324/111.444.ijsp.2015.v4.1.011
2051-5804,1,1,1,0,0,9,9,,10.14324/111.444.ijsp.2017.12
1976-6696 1976-670X,1,1,1,3,27,3,33,,http://dx.doi.org/10.5483/BMBRep.2013.46.2.220
1976-6696 1976-670X,1,1,1,35,2,2,39,,http://dx.doi.org/10.5483/BMBRep.2013.46.7.018
2468-2179 2468-2284,1,1,1,39,0,4,43,,10.1016/j.jsamd.2017.07.005
1900-6586 2500-7645,1,1,1,2,9,21,32,,10.21830/19006586.359
2212-3717,1,1,1,16,0,19,35,,10.1016/j.wri.2017.04.001
1131-5598 1988-2408,1,1,1,0,0,23,23,,10.5209/ARIS.53960
1131-5598 1988-2408,1,1,1,1,0,27,28,,10.5209/ARIS.55505
2205-149X 2205-2062,1,1,1,7,0,18,25,,10.1108/JWAM-08-2016-0013
2090-0201 2090-021X,1,1,1,8,20,0,28,,10.1155/2012/247280
1179-173X,1,1,1,0,29,4,33,,10.1177/1179173X211053357
2227-7382,1,1,1,3,37,1,41,,10.3390/proteomes6010002
2227-7382,1,1,1,1,35,4,40,,10.3390/proteomes5040030
1751-8822 1751-8830,1,1,1,5,29,4,38,,10.1049/smt2.12084
1751-8822 1751-8830,1,1,1,2,25,4,31,,10.1049/smt2.12086
2468-080X,1,1,1,0,50,2,52,,10.1063/5.0053621
2468-080X,1,1,1,0,71,2,73,,10.1063/1.5139023
2213-5766,1,1,1,42,0,16,58,,10.1016/j.epsc.2017.07.011
1449-4035 1839-3373,1,1,1,4,15,32,51,,10.1080/14494035.2018.1427602
2050-9006,1,1,1,8,0,24,32,,10.14324/111.444.amps.2014v6i2.001
2050-9006,1,1,1,2,0,30,32,,10.14324/111.444.amps.2014v4i3.001
2712-7672 2713-2919,1,1,1,1,1,6,8,,10.17650/2712-7672-2020-1-2-64-71
2712-7672 2713-2919,1,1,1,0,12,7,19,,10.17650/2712-7672-2020-1-2-14-20
2712-7672 2713-2919,1,1,1,0,3,0,3,,10.17816/CP70
1474-8460 1474-8479,1,1,1,0,1,2,3,,10.14324/LRE.18.3.16
1474-8460 1474-8479,1,1,1,0,1,0,1,,10.14324/LRE.18.3.15
1474-8460 1474-8479,1,1,1,1,0,1,2,,10.14324/LRE.18.3.18
2272-6977 2257-6614,1,1,1,29,0,22,51,,10.1051/ocl/2021037
1505-9057 2353-1908,1,1,1,0,0,7,7,,10.18778/1505-9057.58.23
1505-9057 2353-1908,1,1,1,0,0,24,24,,10.18778/1505-9057.58.19
1505-9057 2353-1908,1,1,1,0,0,7,7,,10.18778/1505-9057.58.13
1505-9057 2353-1908,1,1,1,6,0,43,49,,10.18778/1505-9057.58.12
1505-9057 2353-1908,1,1,1,2,0,23,25,,10.18778/1505-9057.58.11
1505-9057 2353-1908,1,1,1,0,0,5,5,,10.18778/1505-9057.58.10
1505-9057 2353-1908,1,1,1,5,0,28,33,,10.18778/1505-9057.61.03
1782-1592 2033-7485,1,1,1,0,3,0,3,,10.4000/rsa.608
1782-1592 2033-7485,1,1,1,0,13,0,13,,10.4000/rsa.3268
1782-1592 2033-7485,1,1,1,0,6,0,6,,10.4000/rsa.1755
1782-1592 2033-7485,1,1,1,0,2,0,2,,10.4000/rsa.734
1782-1592 2033-7485,1,1,1,0,12,0,12,,10.4000/rsa.1203
1782-1592 2033-7485,1,1,1,0,15,0,15,,10.4000/rsa.1119
1782-1592 2033-7485,1,1,1,0,2,0,2,,10.4000/rsa.3310
1907-817X,1,1,1,0,7,1,8,,10.14710/presipitasi.v17i3.272-283
1983-9472 2526-7280,1,1,1,1,0,11,12,,10.46401/ajh.2009.v1.3905
1983-9472 2526-7280,1,1,1,5,0,31,36,,10.46401/ajh.2015.v7.2927
1996-9457 1996-9465,1,1,1,3,0,7,10,,10.5194/dwes-10-69-2017
0208-6069 2450-2782,1,1,1,23,0,20,43,,10.18778/0208-6069.96.03
2730-664X,1,1,1,0,31,3,34,,10.1038/s43856-021-00036-w
2730-664X,1,1,1,3,72,0,75,,10.1038/s43856-021-00033-z
2730-664X,1,1,1,1,15,2,18,,10.1038/s43856-021-00037-9
2405-6650,1,1,1,28,0,3,31,,10.1016/j.emcon.2016.05.002
2405-6650,1,1,1,34,0,7,41,,10.1016/j.emcon.2016.05.003
2100-014X,1,1,1,2,0,7,9,,10.1051/epjconf/202125503004
2100-014X,1,1,1,9,0,0,9,,10.1051/epjconf/202125504003
2100-014X,1,1,1,10,0,0,10,,10.1051/epjconf/202125511001
2100-014X,1,1,1,5,0,4,9,,10.1051/epjconf/202125511005
2100-014X,1,1,1,6,0,0,6,,10.1051/epjconf/202125512009
2100-014X,1,1,1,31,0,5,36,,10.1051/epjconf/202125307003
2100-014X,1,1,1,14,0,0,14,,10.1051/epjconf/202125301001
2100-014X,1,1,1,10,0,8,18,,10.1051/epjconf/202125301005
2100-014X,1,1,1,18,0,6,24,,10.1051/epjconf/202125303005
2100-014X,1,1,1,6,0,0,6,,10.1051/epjconf/202125304020
2374-7951,1,1,1,0,10,0,10,,10.1021/acscentsci.0c00482
2374-7951,1,1,1,0,47,2,49,,10.1021/acscentsci.0c00514
2374-7951,1,1,1,0,35,1,36,,10.1021/acscentsci.0c00755
2374-7951,1,1,1,0,7,1,8,,10.1021/acscentsci.0c00164
2374-7951,1,1,1,0,54,0,54,,10.1021/acscentsci.0c00260
2374-7951,1,1,1,0,36,7,43,,10.1021/acscentsci.0c00229
2374-7951,1,1,1,0,99,10,109,,10.1021/acscentsci.0c00988
2374-7951,1,1,1,0,7,0,7,,10.1021/acscentsci.0c01539
2374-7951,1,1,1,1,3,5,9,,10.1021/acscentsci.0c01637
2374-7951,1,1,1,0,9,0,9,,10.1021/acscentsci.0c01549
2374-7951,1,1,1,2,40,0,42,,10.1021/acscentsci.0c00679
2374-7951,1,1,1,1,39,1,41,,10.1021/acscentsci.0c01309
2374-7951,1,1,1,0,10,0,10,,10.1021/acscentsci.1c00108
2374-7951,1,1,1,0,66,3,69,,10.1021/acscentsci.0c01621
2374-7951,1,1,1,0,73,0,73,,10.1021/acscentsci.1c00200
2374-7951,1,1,1,1,65,3,69,,10.1021/acscentsci.1c00024
2374-7951,1,1,1,0,48,2,50,,10.1021/acscentsci.1c00085
2374-7951,1,1,1,0,55,2,57,,10.1021/acscentsci.1c00604
2374-7951,1,1,1,0,38,2,40,,10.1021/acscentsci.1c00611
2374-7951,1,1,1,0,42,3,45,,10.1021/acscentsci.1c00540
2374-7951,1,1,1,1,26,3,30,,10.1021/acscentsci.1c00890
2374-7951,1,1,1,2,44,4,50,,10.1021/acscentsci.1c00960
2374-7951,1,1,1,1,55,3,59,,10.1021/acscentsci.1c00724
2374-7951,1,1,1,0,40,0,40,,10.1021/acscentsci.1c01067
2374-7951,1,1,1,1,62,2,65,,10.1021/acscentsci.7b00556
2374-7951,1,1,1,1,95,2,98,,10.1021/acscentsci.8b00005
2374-7951,1,1,1,5,80,15,100,,10.1021/acscentsci.7b00550
2374-7951,1,1,1,0,11,0,11,,10.1021/acscentsci.8b00077
2374-7951,1,1,1,2,59,4,65,,10.1021/acscentsci.8b00903
2374-7951,1,1,1,0,41,3,44,,10.1021/acscentsci.9b00044
2374-7951,1,1,1,1,57,5,63,,10.1021/acscentsci.9b00130
2374-7951,1,1,1,0,9,0,9,,10.1021/acscentsci.9b00387
2374-7951,1,1,1,1,32,2,35,,10.1021/acscentsci.9b00625
2374-7951,1,1,1,0,9,0,9,,10.1021/acscentsci.9b01284
2374-7951,1,1,1,0,33,0,33,,10.1021/acscentsci.8b00335
2374-7951,1,1,1,2,55,1,58,,10.1021/acscentsci.8b00379
2374-7951,1,1,1,0,58,0,58,,10.1021/acscentsci.8b00401
2374-7951,1,1,1,1,44,0,45,,10.1021/acscentsci.8b00822
2374-7951,1,1,1,0,52,7,59,,10.1021/acscentsci.9b00619
2374-7951,1,1,1,0,9,0,9,,10.1021/acscentsci.0c00087
2374-7951,1,1,1,0,9,0,9,,10.1021/acscentsci.8b00167
2374-7951,1,1,1,0,132,1,133,,10.1021/acscentsci.8b00423
2374-7951,1,1,1,6,43,16,65,,10.1021/acscentsci.8b00700
2374-7951,1,1,1,0,44,0,44,,10.1021/acscentsci.9b00220
2374-7951,1,1,1,0,39,0,39,,10.1021/acscentsci.9b00590
2374-7951,1,1,1,1,72,6,79,,10.1021/acscentsci.9b01277
2374-7951,1,1,1,1,92,4,97,,10.1021/acscentsci.8b00229
2374-7951,1,1,1,0,16,5,21,,10.1021/acscentsci.8b00285
2374-7951,1,1,1,5,42,1,48,,10.1021/acscentsci.8b00882
2374-7951,1,1,1,0,81,1,82,,10.1021/acscentsci.9b00102
2374-7951,1,1,1,0,52,1,53,,10.1021/acscentsci.9b00423
2374-7951,1,1,1,0,10,0,10,,10.1021/acscentsci.9b00832
2374-7951,1,1,1,0,10,0,10,,10.1021/acscentsci.9b00887
2374-7951,1,1,1,1,175,5,181,,10.1021/acscentsci.9b01139
2374-7951,1,1,1,0,70,6,76,,10.1021/acscentsci.7b00555
2374-7951,1,1,1,2,88,1,91,,10.1021/acscentsci.7b00432
2374-7951,1,1,1,1,87,1,89,,10.1021/acscentsci.8b00369
2374-7951,1,1,1,0,6,0,6,,10.1021/acscentsci.8b00706
2374-7951,1,1,1,4,65,6,75,,10.1021/acscentsci.9b00372
2374-7951,1,1,1,0,9,0,9,,10.1021/acscentsci.9b00461
2374-7951,1,1,1,1,39,0,40,,10.1021/acscentsci.7b00577
2374-7951,1,1,1,0,8,0,8,,10.1021/acscentsci.8b00156
2374-7951,1,1,1,0,41,0,41,,10.1021/acscentsci.7b00582
2374-7951,1,1,1,0,60,0,60,,10.1021/acscentsci.8b00042
2374-7951,1,1,1,0,35,3,38,,10.1021/acscentsci.8b00108
2374-7951,1,1,1,0,35,2,37,,10.1021/acscentsci.8b00168
2374-7951,1,1,1,0,50,0,50,,10.1021/acscentsci.8b00257
2374-7951,1,1,1,2,26,0,28,,10.1021/acscentsci.8b00193
2374-7951,1,1,1,0,1,0,1,,10.1021/acscentsci.8b00430
2374-7951,1,1,1,0,6,1,7,,10.1021/acscentsci.8b00492
2374-7951,1,1,1,0,51,0,51,,10.1021/acscentsci.8b00471
2374-7951,1,1,1,1,107,4,112,,10.1021/acscentsci.8b00628
2374-7951,1,1,1,0,37,0,37,,10.1021/acscentsci.8b00568
2374-7951,1,1,1,3,59,6,68,,10.1021/acscentsci.8b00669
2374-7951,1,1,1,2,92,0,94,,10.1021/acscentsci.8b00773
2374-7951,1,1,1,0,10,0,10,,10.1021/acscentsci.9b00099
2374-7951,1,1,1,1,32,10,43,,10.1021/acscentsci.9b00055
2374-7951,1,1,1,0,34,0,34,,10.1021/acscentsci.9b00163
2374-7951,1,1,1,0,84,4,88,,10.1021/acscentsci.9b00194
2374-7951,1,1,1,0,58,1,59,,10.1021/acscentsci.9b00052
2374-7951,1,1,1,1,88,0,89,,10.1021/acscentsci.9b00300
2374-7951,1,1,1,0,45,2,47,,10.1021/acscentsci.9b00403
2374-7951,1,1,1,0,8,1,9,,10.1021/acscentsci.9b00910
2374-7951,1,1,1,2,73,4,79,,10.1021/acscentsci.9b00193
2374-7951,1,1,1,1,74,1,76,,10.1021/acscentsci.9b00093
2374-7951,1,1,1,0,61,0,61,,10.1021/acscentsci.9b00053
2374-7951,1,1,1,3,99,1,103,,10.1021/acscentsci.8b00755
2374-7951,1,1,1,1,9,0,10,,10.1021/acscentsci.9b00320
2374-7951,1,1,1,0,139,0,139,,10.1021/acscentsci.0c00251
2374-7951,1,1,1,3,36,20,59,,10.1021/acscentsci.9b00804
2374-7951,1,1,1,0,51,0,51,,10.1021/acscentsci.0c00411
2374-7951,1,1,1,2,47,2,51,,10.1021/acscentsci.9b00743
2374-7951,1,1,1,1,63,0,64,,10.1021/acscentsci.0c00385
2374-7951,1,1,1,0,53,0,53,,10.1021/acscentsci.0c00568
2374-7951,1,1,1,0,28,2,30,,10.1021/acscentsci.9b01006
2374-7951,1,1,1,0,44,0,44,,10.1021/acscentsci.9b00982
2374-7951,1,1,1,0,59,1,60,,10.1021/acscentsci.9b01042
2374-7951,1,1,1,1,46,0,47,,10.1021/acscentsci.0c00953
2374-7951,1,1,1,1,66,7,74,,10.1021/acscentsci.0c01379
2374-7951,1,1,1,0,36,0,36,,10.1021/acscentsci.0c00763
2374-7951,1,1,1,0,107,3,110,,10.1021/acscentsci.0c01030
2374-7951,1,1,1,0,43,1,44,,10.1021/acscentsci.9b00706
2374-7951,1,1,1,0,66,0,66,,10.1021/acscentsci.0c00552
2374-7951,1,1,1,0,44,2,46,,10.1021/acscentsci.0c01151
2374-7951,1,1,1,0,41,0,41,,10.1021/acscentsci.0c01522
2374-7951,1,1,1,2,239,5,246,,10.1021/acscentsci.0c01493
2374-7951,1,1,1,0,76,4,80,,10.1021/acscentsci.1c00148
2374-7951,1,1,1,0,45,3,48,,10.1021/acscentsci.1c00483
2374-7951,1,1,1,0,8,2,10,,10.1021/acscentsci.1c00887
2374-7951,1,1,1,0,82,0,82,,10.1021/acscentsci.1c00499
2374-7951,1,1,1,1,62,0,63,,10.1021/acscentsci.9b00551
2374-7951,1,1,1,0,8,1,9,,10.1021/acscentsci.9b00954
2374-7951,1,1,1,0,108,0,108,,10.1021/acscentsci.0c00690
2374-7951,1,1,1,1,104,12,117,,10.1021/acscentsci.0c00592
2374-7951,1,1,1,0,97,0,97,,10.1021/acscentsci.0c01022
2374-7951,1,1,1,3,169,4,176,,10.1021/acscentsci.0c00599
2374-7951,1,1,1,1,50,2,53,,10.1021/acscentsci.9b00200
2374-7951,1,1,1,1,39,1,41,,10.1021/acscentsci.9b00327
2374-7951,1,1,1,0,44,0,44,,10.1021/acscentsci.9b00212
2374-7951,1,1,1,0,9,0,9,,10.1021/acscentsci.9b00842
2374-7951,1,1,1,1,73,0,74,,10.1021/acscentsci.7b00237
2374-7951,1,1,1,0,37,1,38,,10.1021/acscentsci.7b00544
2374-7951,1,1,1,0,10,0,10,,10.1021/acscentsci.8b00087
2374-7951,1,1,1,0,135,0,135,,10.1021/acscentsci.8b00073
2374-7951,1,1,1,0,10,0,10,,10.1021/acscentsci.8b00527
2374-7951,1,1,1,0,76,3,79,,10.1021/acscentsci.0c00567
2374-7951,1,1,1,0,12,1,13,,10.1021/acscentsci.1c00555
2374-7951,1,1,1,0,47,0,47,,10.1021/acscentsci.9b01174
2374-7951,1,1,1,0,10,0,10,,10.1021/acscentsci.0c01187
2374-7951,1,1,1,0,32,0,32,,10.1021/acscentsci.0c00742
2374-7951,1,1,1,2,38,0,40,,10.1021/acscentsci.0c01146
2374-7951,1,1,1,0,8,1,9,,10.1021/acscentsci.0c01576
2374-7951,1,1,1,0,48,0,48,,10.1021/acscentsci.1c00173
2374-7951,1,1,1,0,19,1,20,,10.1021/acscentsci.9b00806
2374-7951,1,1,1,0,71,1,72,,10.1021/acscentsci.9b01005
2374-7951,1,1,1,0,79,6,85,,10.1021/acscentsci.0c00587
2300-9705 2353-2807,1,1,1,0,10,0,10,,10.18276/cej.2017.4-06
1133-9527 1988-2394,1,1,1,1,0,47,48,,10.5209/CFIT.54006
1133-9527 1988-2394,1,1,1,1,0,0,1,,10.5209/CFIT.54016
1133-9527 1988-2394,1,1,1,12,0,38,50,,10.5209/rev_CFIT.2015.v22.50950
1133-9527 1988-2394,1,1,1,0,0,44,44,,10.5209/CFIT.54001
1133-9527 1988-2394,1,1,1,0,0,47,47,,10.5209/CFIT.58138
2624-909X,1,1,1,1,11,11,23,,10.3389/fdata.2021.790158
2624-909X,1,1,1,12,5,5,22,,10.3389/fdata.2019.00048
2624-909X,1,1,1,8,16,49,73,,10.3389/fdata.2020.00005
1958-5500,1,1,1,0,25,0,25,,10.4000/espacepolitique.4251
1958-5500,1,1,1,0,7,0,7,,10.4000/espacepolitique.270
1958-5500,1,1,1,0,12,0,12,,10.4000/espacepolitique.2644
1958-5500,1,1,1,0,28,0,28,,10.4000/espacepolitique.1781
1958-5500,1,1,1,0,16,0,16,,10.4000/espacepolitique.8275
1958-5500,1,1,1,0,13,0,13,,10.4000/espacepolitique.8715
1958-5500,1,1,1,0,19,0,19,,10.4000/espacepolitique.8496
2673-4842,1,1,1,0,19,1,20,,10.3389/froh.2021.638213
2297-4687,1,1,1,3,7,10,20,,10.3389/fams.2020.611854
2297-4687,1,1,1,11,77,6,94,,10.3389/fams.2019.00052
1226-1726 2384-0544,1,1,1,0,19,3,22,,10.15857/ksep.2021.30.1.34
1226-1726 2384-0544,1,1,1,0,30,4,34,,10.15857/ksep.2020.29.3.256
1226-1726 2384-0544,1,1,1,0,25,2,27,,10.15857/ksep.2020.29.1.34
0100-6045 2317-630X,1,1,1,14,0,48,62,,10.1590/0100-6045.2017.v40n3.sc
0100-6045 2317-630X,1,1,1,4,0,12,16,,10.1590/S0100-60452011000100009
0100-6045 2317-630X,1,1,1,0,0,20,20,,10.1590/S0100-60452012000200001
1822-427X 1822-4288,1,1,1,1,21,5,27,,10.7250/bjrbe.2021-16.514
1755-4365 1878-0067,1,1,1,50,0,7,57,,10.1016/j.epidem.2015.08.003
1755-4365 1878-0067,1,1,1,36,0,4,40,,10.1016/j.epidem.2015.06.002
2090-150X 2090-1518,1,1,1,0,19,3,22,,10.1155/2015/292505
2474-252X,1,1,1,3,11,1,15,,10.5811/cpcem.2021.8.53524
2474-252X,1,1,1,1,2,1,4,,10.5811/cpcem.2021.7.53199
2474-252X,1,1,1,1,4,0,5,,10.5811/cpcem.2021.5.51875
2474-252X,1,1,1,2,11,4,17,,10.5811/cpcem.2020.4.46301
2474-252X,1,1,1,1,3,0,4,,10.5811/cpcem.2020.5.48023
2474-252X,1,1,1,3,8,2,13,,10.5811/cpcem.2020.3.45266
2474-252X,1,1,1,1,11,1,13,,10.5811/cpcem.2020.7.48292
2474-252X,1,1,1,3,11,1,15,,10.5811/cpcem.2020.7.47237
1519-311X 1982-2553,1,1,1,8,0,25,33,,10.1590/1982-25542015120031
1519-311X 1982-2553,1,1,1,3,0,10,13,,10.1590/1982-25542015120241
1929-5804 1929-5812,1,1,1,0,1,0,1,,10.5267/j.dsl.2016.1.002
2226-3012 2412-124X,1,1,1,0,1,29,30,,10.28925/2226-3012.2021.101
2226-3012 2412-124X,1,1,1,1,11,9,21,,10.28925/2226-3012.2021.109
2226-3012 2412-124X,1,1,1,0,25,5,30,,10.28925/2226-3012.2021.105
2226-3012 2412-124X,1,1,1,0,12,5,17,,10.28925/2226-3012.2021.108
2577-171X,1,1,1,0,1,0,1,,10.1002/iju5.12200
2577-171X,1,1,1,0,15,3,18,,10.1002/iju5.12262
2577-171X,1,1,1,0,15,0,15,,10.1002/iju5.12273
2577-171X,1,1,1,0,13,0,13,,10.1002/iju5.12284
2577-171X,1,1,1,0,4,0,4,,10.1002/iju5.12134
0970-0358 1998-376X,1,1,1,0,0,5,5,,10.4103/ijps.IJPS_73_18
0970-0358 1998-376X,1,1,1,0,0,2,2,,10.4103/0970-0358.197239
0970-0358 1998-376X,1,1,1,0,0,19,19,,10.4103/0970-0358.182240
0970-0358 1998-376X,1,1,1,0,0,5,5,,10.4103/0970-0358.155264
0970-0358 1998-376X,1,1,1,0,0,17,17,,10.4103/0970-0358.129648
0970-0358 1998-376X,1,1,1,2,0,18,20,,10.4103/0970-0358.129619
0970-0358 1998-376X,1,1,1,0,0,4,4,,10.4103/0970-0358.146695
0970-0358 1998-376X,1,1,1,0,0,11,11,,10.4103/0970-0358.96617
2691-3704,1,1,1,1,87,8,96,,10.1021/jacsau.0c00094
2691-3704,1,1,1,0,21,0,21,,10.1021/jacsau.1c00098
2691-3704,1,1,1,0,46,0,46,,10.1021/jacsau.0c00114
2691-3704,1,1,1,0,47,0,47,,10.1021/jacsau.1c00044
2691-3704,1,1,1,0,72,1,73,,10.1021/jacsau.1c00160
2691-3704,1,1,1,0,56,1,57,,10.1021/jacsau.1c00179
2691-3704,1,1,1,0,61,0,61,,10.1021/jacsau.1c00155
2691-3704,1,1,1,0,38,1,39,,10.1021/jacsau.1c00068
2691-3704,1,1,1,0,49,0,49,,10.1021/jacsau.1c00186
2691-3704,1,1,1,0,65,1,66,,10.1021/jacsau.1c00343
2691-3704,1,1,1,0,60,1,61,,10.1021/jacsau.1c00350
2691-3704,1,1,1,0,75,1,76,,10.1021/jacsau.0c00003
2691-3704,1,1,1,0,54,0,54,,10.1021/jacsau.0c00002
2691-3704,1,1,1,0,96,4,100,,10.1021/jacsau.0c00110
2691-3704,1,1,1,0,60,1,61,,10.1021/jacsau.1c00004
2691-3704,1,1,1,0,226,1,227,,10.1021/jacsau.1c00128
2691-3704,1,1,1,0,123,4,127,,10.1021/jacsau.1c00121
2691-3704,1,1,1,0,42,0,42,,10.1021/jacsau.1c00168
2691-3704,1,1,1,0,62,0,62,,10.1021/jacsau.1c00158
2691-3704,1,1,1,2,34,3,39,,10.1021/jacsau.1c00202
2691-3704,1,1,1,0,37,1,38,,10.1021/jacsau.1c00289
2691-3704,1,1,1,1,49,0,50,,10.1021/jacsau.0c00070
2691-3704,1,1,1,0,56,0,56,,10.1021/jacsau.0c00092
2691-3704,1,1,1,0,40,0,40,,10.1021/jacsau.1c00145
2691-3704,1,1,1,0,59,2,61,,10.1021/jacsau.1c00349
2691-3704,1,1,1,0,90,3,93,,10.1021/jacsau.1c00311
2691-3704,1,1,1,6,32,0,38,,10.1021/jacsau.1c00423
2694-2461,1,1,1,0,62,0,62,,10.1021/acsmaterialsau.1c00020
2694-2461,1,1,1,0,76,1,77,,10.1021/acsmaterialsau.1c00026
2694-250X,1,1,1,1,43,6,50,,10.1021/acsmeasuresciau.1c00013
2694-250X,1,1,1,0,86,3,89,,10.1021/acsmeasuresciau.1c00019
0101-6040,1,1,1,3,5,19,27,,https://doi.org/10.36659/dae.2020.037
0101-6040,1,1,1,2,26,21,49,,10.36659/dae.2020.028
0101-6040,1,1,1,1,3,71,75,,10.36659/dae.2020.015
0101-6040,1,1,1,5,7,10,22,,10.36659/dae.2020.011
2056-3132,1,1,1,1,38,1,40,,10.1186/s40850-020-00060-8
2397-0642,1,1,1,0,43,13,56,,10.1186/s41256-019-0118-y
2397-0642,1,1,1,35,20,14,69,,10.1186/s41256-021-00230-2
2397-0642,1,1,1,0,13,10,23,,10.1186/s41256-021-00231-1
2096-3041 2662-6802,1,1,1,0,0,11,11,,10.1186/BF03545700
2096-3041 2662-6802,1,1,1,0,1,0,1,,10.1186/s43238-021-00023-z
0035-1121 1760-7426,1,1,1,0,7,0,7,,10.4000/rga.9337
1110-256X 2090-9128,1,1,1,25,0,4,29,,10.1016/j.joems.2013.11.003
1110-256X 2090-9128,1,1,1,17,0,4,21,,10.1016/j.joems.2014.10.001
1110-256X 2090-9128,1,1,1,8,0,8,16,,10.1016/j.joems.2013.03.004
1110-256X 2090-9128,1,1,1,18,0,6,24,,10.1016/j.joems.2013.11.006
1110-256X 2090-9128,1,1,1,0,30,0,30,,10.1186/s42787-020-00079-3
2364-3404 2364-3412,1,1,1,5,11,25,41,,10.1186/s41018-018-0045-4
1594-4077 1828-051X,1,1,1,1,24,1,26,,10.4081/ijas.2014.3227
1594-4077 1828-051X,1,1,1,12,0,3,15,,10.4081/ijas.2009.s2.558
1594-4077 1828-051X,1,1,1,6,18,10,34,,10.4081/ijas.2015.3352
1594-4077 1828-051X,1,1,1,2,18,24,44,,10.4081/ijas.2010.e9
1594-4077 1828-051X,1,1,1,2,0,5,7,,10.4081/ijas.2007.s2.540
1594-4077 1828-051X,1,1,1,3,14,9,26,,10.4081/ijas.2012.e40
1594-4077 1828-051X,1,1,1,4,28,10,42,,10.4081/ijas.2015.3877
1594-4077 1828-051X,1,1,1,3,31,8,42,,10.4081/ijas.2013.e78
1594-4077 1828-051X,1,1,1,0,0,5,5,,10.4081/ijas.2007.s2.528
1594-4077 1828-051X,1,1,1,2,0,1,3,,10.4081/ijas.2007.1s.370
1594-4077 1828-051X,1,1,1,13,5,8,26,,10.4081/ijas.2004.259
1594-4077 1828-051X,1,1,1,14,0,10,24,,10.4081/ijas.2002.113
1594-4077 1828-051X,1,1,1,0,10,4,14,,10.4081/ijas.2012.e57
1594-4077 1828-051X,1,1,1,9,0,1,10,,10.4081/ijas.2007.s2.632
1594-4077 1828-051X,1,1,1,0,12,8,20,,10.1080/1828051X.2017.1279034
1594-4077 1828-051X,1,1,1,0,32,3,35,,10.1080/1828051X.2016.1239511
1594-4077 1828-051X,1,1,1,1,20,9,30,,10.1080/1828051X.2017.1335183
1594-4077 1828-051X,1,1,1,5,0,10,15,,10.4081/ijas.2009.s2.516
1594-4077 1828-051X,1,1,1,32,0,8,40,,10.4081/ijas.2007.5
1594-4077 1828-051X,1,1,1,4,0,4,8,,10.4081/ijas.2009.s3.276
1594-4077 1828-051X,1,1,1,4,0,2,6,,10.4081/ijas.2009.s2.393
1594-4077 1828-051X,1,1,1,9,0,0,9,,10.4081/ijas.2009.s2.66
1594-4077 1828-051X,1,1,1,0,26,19,45,,10.1080/1828051X.2020.1743784
1594-4077 1828-051X,1,1,1,1,18,27,46,,10.1080/1828051X.2020.1757522
1594-4077 1828-051X,1,1,1,1,41,26,68,,10.1080/1828051X.2020.1761270
1594-4077 1828-051X,1,1,1,0,47,2,49,,10.1080/1828051X.2020.1769511
1594-4077 1828-051X,1,1,1,0,29,11,40,,10.1080/1828051X.2020.1773949
1594-4077 1828-051X,1,1,1,0,67,17,84,,10.1080/1828051X.2020.1778548
1594-4077 1828-051X,1,1,1,0,43,5,48,,10.1080/1828051X.2020.1783378
1594-4077 1828-051X,1,1,1,0,37,6,43,,10.1080/1828051X.2020.1787882
1594-4077 1828-051X,1,1,1,0,37,16,53,,10.1080/1828051X.2020.1807419
1594-4077 1828-051X,1,1,1,0,32,15,47,,10.1080/1828051X.2020.1816510
1594-4077 1828-051X,1,1,1,0,39,5,44,,10.1080/1828051X.2020.1827991
1594-4077 1828-051X,1,1,1,1,30,9,40,,10.1080/1828051X.2020.1846468
1594-4077 1828-051X,1,1,1,1,52,6,59,,10.1080/1828051X.2020.1847606
1594-4077 1828-051X,1,1,1,0,44,3,47,,10.1080/1828051X.2020.1857311
1594-4077 1828-051X,1,1,1,6,16,21,43,,10.1080/1828051X.2016.1204633
1594-4077 1828-051X,1,1,1,0,53,6,59,,10.1080/1828051X.2019.1691472
1865-3499,1,1,1,0,48,5,53,,10.1186/s12263-018-0612-8
1754-1611,1,1,1,45,1,5,51,,10.1186/s13036-017-0065-4
1754-1611,1,1,1,62,0,1,63,,10.1186/s13036-017-0055-6
1754-1611,1,1,1,2,47,1,50,,10.1186/s13036-019-0183-2
2391-4238,1,1,1,6,0,10,16,,10.1515/amsil-2017-0012
2391-4238,1,1,1,8,0,9,17,,10.1515/amsil-2017-0014
2391-4238,1,1,1,12,0,5,17,,10.2478/amsil-2020-0012
1692-2530 2248-4078,1,1,1,1,1,39,41,,https://doi.org/10.22395/ojum.v17n35a11
2525-4863,1,1,1,0,69,12,81,,10.20873/uft.rbec.e12965
2525-4863,1,1,1,0,24,9,33,,10.20873/uft.rbec.e12966
1544-9173 1545-7885,1,1,1,98,0,10,108,,10.1371/journal.pbio.3000106
1544-9173 1545-7885,1,1,1,9,0,1,10,,10.1371/journal.pbio.3001192
1544-9173 1545-7885,1,1,1,36,0,4,40,,10.1371/journal.pbio.3001323
1544-9173 1545-7885,1,1,1,49,0,5,54,,10.1371/journal.pbio.0050305
1544-9173 1545-7885,1,1,1,34,0,2,36,,10.1371/journal.pbio.1000211
1544-9173 1545-7885,1,1,1,39,0,5,44,,10.1371/journal.pbio.3001348
1544-9173 1545-7885,1,1,1,48,0,1,49,,10.1371/journal.pbio.1001106
1544-9173 1545-7885,1,1,1,43,0,1,44,,10.1371/journal.pbio.1000625
1544-9173 1545-7885,1,1,1,31,0,1,32,,10.1371/journal.pbio.1000533
1544-9173 1545-7885,1,1,1,34,0,2,36,,10.1371/journal.pbio.1000613
1544-9173 1545-7885,1,1,1,34,0,0,34,,10.1371/journal.pbio.1000464
1544-9173 1545-7885,1,1,1,43,0,3,46,,10.1371/journal.pbio.1001086
1544-9173 1545-7885,1,1,1,78,0,9,87,,10.1371/journal.pbio.1001013
1544-9173 1545-7885,1,1,1,64,0,1,65,,10.1371/journal.pbio.1001025
1544-9173 1545-7885,1,1,1,32,0,3,35,,10.1371/journal.pbio.1000591
1544-9173 1545-7885,1,1,1,53,0,6,59,,10.1371/journal.pbio.1000547
1544-9173 1545-7885,1,1,1,38,0,2,40,,10.1371/journal.pbio.1001237
1544-9173 1545-7885,1,1,1,35,0,2,37,,10.1371/journal.pbio.1001135
1544-9173 1545-7885,1,1,1,25,0,4,29,,10.1371/journal.pbio.1001295
1544-9173 1545-7885,1,1,1,39,0,9,48,,10.1371/journal.pbio.1001205
1544-9173 1545-7885,1,1,1,29,0,9,38,,10.1371/journal.pbio.1001127
1544-9173 1545-7885,1,1,1,38,0,25,63,,10.1371/journal.pbio.1001124
1544-9173 1545-7885,1,1,1,78,0,2,80,,10.1371/journal.pbio.1001194
1544-9173 1545-7885,1,1,1,27,0,2,29,,10.1371/journal.pbio.1001307
1544-9173 1545-7885,1,1,1,46,0,1,47,,10.1371/journal.pbio.1001137
1544-9173 1545-7885,1,1,1,38,0,3,41,,10.1371/journal.pbio.1001256
1544-9173 1545-7885,1,1,1,0,0,47,47,,10.1371/journal.pbio.0050284
1544-9173 1545-7885,1,1,1,2,0,19,21,,10.1371/journal.pbio.0060175
1544-9173 1545-7885,1,1,1,0,0,38,38,,10.1371/journal.pbio.0050315
1544-9173 1545-7885,1,1,1,3,0,54,57,,10.1371/journal.pbio.0060068
1544-9173 1545-7885,1,1,1,0,0,89,89,,10.1371/journal.pbio.1000058
1544-9173 1545-7885,1,1,1,1,0,65,66,,10.1371/journal.pbio.0060214
1544-9173 1545-7885,1,1,1,33,0,5,38,,10.1371/journal.pbio.1000339
1544-9173 1545-7885,1,1,1,6,0,11,17,,10.1371/journal.pbio.1001353
1544-9173 1545-7885,1,1,1,72,0,3,75,,10.1371/journal.pbio.1001364
1544-9173 1545-7885,1,1,1,67,0,6,73,,10.1371/journal.pbio.1001335
1544-9173 1545-7885,1,1,1,48,0,7,55,,10.1371/journal.pbio.1000564
1544-9173 1545-7885,1,1,1,44,0,0,44,,10.1371/journal.pbio.1000402
1544-9173 1545-7885,1,1,1,24,0,1,25,,10.1371/journal.pbio.1000359
1544-9173 1545-7885,1,1,1,38,0,3,41,,10.1371/journal.pbio.1000361
1544-9173 1545-7885,1,1,1,65,0,7,72,,10.1371/journal.pbio.1000527
1544-9173 1545-7885,1,1,1,64,0,0,64,,10.1371/journal.pbio.1000484
1544-9173 1545-7885,1,1,1,97,0,6,103,,10.1371/journal.pbio.1000475
1544-9173 1545-7885,1,1,1,47,0,5,52,,10.1371/journal.pbio.1000497
1544-9173 1545-7885,1,1,1,33,0,6,39,,10.1371/journal.pbio.1001520
1544-9173 1545-7885,1,1,1,55,0,0,55,,10.1371/journal.pbio.1001635
1544-9173 1545-7885,1,1,1,89,0,8,97,,10.1371/journal.pbio.1001579
1544-9173 1545-7885,1,1,1,59,0,16,75,,10.1371/journal.pbio.1001555
1544-9173 1545-7885,1,1,1,67,0,5,72,,10.1371/journal.pbio.1001434
1544-9173 1545-7885,1,1,1,59,0,2,61,,10.1371/journal.pbio.1001620
1544-9173 1545-7885,1,1,1,22,0,27,49,,10.1371/journal.pbio.1001426
1544-9173 1545-7885,1,1,1,50,0,3,53,,10.1371/journal.pbio.1001350
1544-9173 1545-7885,1,1,1,68,0,4,72,,10.1371/journal.pbio.1001710
1544-9173 1545-7885,1,1,1,50,0,7,57,,10.1371/journal.pbio.1000623
1544-9173 1545-7885,1,1,1,46,0,4,50,,10.1371/journal.pbio.1000616
1544-9173 1545-7885,1,1,1,60,0,1,61,,10.1371/journal.pbio.1000612
1544-9173 1545-7885,1,1,1,53,0,6,59,,10.1371/journal.pbio.3001385
1544-9173 1545-7885,1,1,1,74,0,3,77,,10.1371/journal.pbio.1001775
1544-9173 1545-7885,1,1,1,65,0,2,67,,10.1371/journal.pbio.1001776
1544-9173 1545-7885,1,1,1,114,0,4,118,,10.1371/journal.pbio.1001781
2405-4739 2618-7213,1,1,1,9,0,12,21,,10.1016/j.ruje.2016.06.003
2405-4739 2618-7213,1,1,1,35,0,20,55,,10.1016/j.ruje.2016.02.004
2166-3831,1,1,1,0,37,3,40,,10.1080/21663831.2017.1402098
2166-3831,1,1,1,0,27,1,28,,10.1080/21663831.2021.1893233
2166-3831,1,1,1,1,45,4,50,,10.1080/21663831.2020.1821111
2166-3831,1,1,1,0,27,0,27,,10.1080/21663831.2020.1818324
2166-3831,1,1,1,0,18,0,18,,10.1080/21663831.2020.1721586
2036-3176 2036-7902,1,1,1,0,15,0,15,,10.1186/s13089-018-0084-5
1991-9336,1,1,1,0,5,0,5,,10.4000/ejas.10335
1991-9336,1,1,1,0,3,0,3,,10.4000/ejas.12967
1991-9336,1,1,1,0,27,0,27,,10.4000/ejas.14045
1991-9336,1,1,1,0,5,0,5,,10.4000/ejas.10396
2275-1785,1,1,1,0,5,0,5,,10.4000/etudesplatoniciennes.1458
2275-1785,1,1,1,0,34,0,34,,10.4000/etudesplatoniciennes.997
2275-1785,1,1,1,0,1,0,1,,10.4000/etudesplatoniciennes.923
2050-2680,1,1,1,0,13,19,32,,10.1002/app5.285
2056-3485,1,1,1,0,13,8,21,,10.1002/rse2.96
2056-3485,1,1,1,1,33,13,47,,10.1002/rse2.101
0102-8529 1982-0240,1,1,1,0,0,6,6,,10.1590/s0102-8529.2019410100012
0102-8529 1982-0240,1,1,1,0,0,92,92,,10.1590/S0102-85292005000100002
2492-6035,1,1,1,4,0,3,7,,10.1051/sbuild/2016006
2492-6035,1,1,1,5,0,2,7,,10.1051/sbuild/2016003
2235-042X,1,1,1,0,8,3,11,,10.1177/2633556521993993
2331-1843,1,1,1,0,19,21,40,,10.1080/23311843.2019.1592064
2331-1843,1,1,1,1,49,7,57,,10.1080/23311843.2019.1650416
2331-1843,1,1,1,0,20,14,34,,10.1080/23311843.2019.1708184
2331-1843,1,1,1,0,19,4,23,,10.1080/23311843.2017.1323376
2331-1843,1,1,1,0,21,15,36,,10.1080/23311843.2017.1339386
2331-1843,1,1,1,0,9,40,49,,10.1080/23311843.2017.1339387
2331-1843,1,1,1,0,40,20,60,,10.1080/23311843.2017.1405887
2331-1843,1,1,1,1,38,52,91,,10.1080/23311843.2017.1405888
2331-1843,1,1,1,0,31,13,44,,10.1080/23311843.2016.1249107
2331-1843,1,1,1,0,17,0,17,,10.1080/23311843.2016.1259880
2331-1843,1,1,1,0,8,16,24,,10.1080/23311843.2020.1778996
2331-1843,1,1,1,1,45,36,82,,10.1080/23311843.2020.1823631
2331-1843,1,1,1,0,13,9,22,,10.1080/23311843.2015.1136099
2096-4471 2574-5417,1,1,1,1,40,15,56,,10.1080/20964471.2020.1766180
2073-7378 2518-1661,1,1,1,3,0,13,16,,10.30748/zhups.2021.70.19
2639-5908 2639-5916,1,1,1,1,47,16,64,,10.1080/26395916.2019.1699164
2641-5275,1,1,1,0,25,10,35,,10.1080/26415275.2019.1708201
2641-5275,1,1,1,1,36,18,55,,10.1080/26415275.2020.1728277
2641-5275,1,1,1,0,22,2,24,,10.1080/26415275.2020.1770094
2641-5275,1,1,1,2,59,3,64,,10.1080/26415275.2020.1829489
2237-2660,1,1,1,0,0,29,29,,10.1590/2237-266076227
2471-2531,1,1,1,43,0,1,44,,10.1097/PR9.0000000000000680
2471-2531,1,1,1,49,0,1,50,,10.1097/PR9.0000000000000960
2471-2531,1,1,1,25,0,1,26,,10.1097/PR9.0000000000000936
2471-2531,1,1,1,19,0,0,19,,10.1097/PR9.0000000000000938
2694-2453,1,1,1,0,68,0,68,,10.1021/acspolymersau.1c00010
2694-2453,1,1,1,1,78,5,84,,10.1021/acspolymersau.1c00028
0214-0314 1988-8295,1,1,1,4,0,12,16,,10.5209/CUTS.56461
1018-9556 2414-3324,1,1,1,0,3,38,41,,https://doi.org/10.46222/pharosjot.1031
1110-0362 2589-0409,1,1,1,0,18,0,18,,10.1186/s43046-020-00024-6
2195-3325,1,1,1,1,36,17,54,,10.5964/jspp.v8i1.1145
2195-3325,1,1,1,11,42,45,98,,10.5964/jspp.v4i1.520
1390-0129 2477-8990,1,1,1,0,8,8,16,,10.33333/rp.vol45n1.04
1390-0129 2477-8990,1,1,1,0,6,7,13,,10.33333/rp.vol44n2.05
2007-5995 2683-1783,1,1,1,0,6,21,27,,https://doi.org/10.22201/fder.26831783e.2019.10.88
1794-5992 2389-783X,1,1,1,0,5,31,36,,10.21676/2389783X.3321
1869-4187 1869-4195,1,1,1,3,37,8,48,,10.1007/s13209-019-0191-y
2331-1932,1,1,1,0,8,16,24,,10.1080/23311932.2019.1627779
2331-1932,1,1,1,0,11,9,20,,10.1080/23311932.2019.1641903
2331-1932,1,1,1,0,0,40,40,,10.1080/23311932.2019.1643518
2331-1932,1,1,1,0,6,16,22,,10.1080/23311932.2019.1659212
2331-1932,1,1,1,1,13,15,29,,10.1080/23311932.2019.1664203
2331-1932,1,1,1,0,17,20,37,,10.1080/23311932.2019.1679700
2331-1932,1,1,1,0,7,19,26,,10.1080/23311932.2019.1682230
2331-1932,1,1,1,1,7,35,43,,10.1080/23311932.2019.1690829
2331-1932,1,1,1,0,40,5,45,,10.1080/23311932.2019.1577532
2331-1932,1,1,1,0,5,16,21,,10.1080/23311932.2019.1607430
2331-1932,1,1,1,0,15,12,27,,10.1080/23311932.2017.1421415
2331-1932,1,1,1,0,32,11,43,,10.1080/23311932.2018.1435019
2331-1932,1,1,1,0,33,5,38,,10.1080/23311932.2018.1475925
2331-1932,1,1,1,0,26,44,70,,10.1080/23311932.2018.1477232
2331-1932,1,1,1,88,0,29,117,,10.1080/23311932.2015.1127500
2331-1932,1,1,1,8,0,5,13,,10.1080/23311932.2015.1134379
2331-1932,1,1,1,26,0,14,40,,10.1080/23311932.2016.1145783
2331-1932,1,1,1,23,0,33,56,,10.1080/23311932.2016.1153767
2331-1932,1,1,1,50,0,3,53,,10.1080/23311932.2016.1174973
2331-1932,1,1,1,12,0,21,33,,10.1080/23311932.2016.1179161
2331-1932,1,1,1,19,0,1,20,,10.1080/23311932.2016.1186139
2331-1932,1,1,1,24,0,9,33,,10.1080/23311932.2015.1124486
2331-1932,1,1,1,22,0,7,29,,10.1080/23311932.2016.1213618
2331-1932,1,1,1,11,0,25,36,,10.1080/23311932.2016.1224485
2331-1932,1,1,1,17,0,15,32,,10.1080/23311932.2016.1235458
2331-1932,1,1,1,16,0,12,28,,10.1080/23311932.2016.1269979
2331-1932,1,1,1,0,27,55,82,,10.1080/23311932.2017.1358338
2331-1932,1,1,1,0,11,9,20,,10.1080/23311932.2017.1369345
2331-1932,1,1,1,0,6,19,25,,10.1080/23311932.2017.1375378
2331-1932,1,1,1,0,3,12,15,,10.1080/23311932.2018.1519008
2331-1932,1,1,1,1,13,15,29,,10.1080/23311932.2018.1519972
2331-1932,1,1,1,0,19,13,32,,10.1080/23311932.2018.1525147
2331-1932,1,1,1,1,17,19,37,,10.1080/23311932.2018.1504507
2383-2312,1,1,1,25,0,19,44,,10.29252/jech.7.1.13
2383-2312,1,1,1,13,0,13,26,,10.29252/jech.7.1.59
2383-2312,1,1,1,19,0,21,40,,10.29252/jech.7.3.187
2712-7621,1,1,1,2,0,10,12,,10.18384/2712-7621-2020-4-70-86
2602-4217,1,1,1,5,0,21,26,,https://doi.org/10.38088/jise.456673
0288-4534 2187-5537,1,1,1,3,30,4,37,,10.14356/kona.2021008
0288-4534 2187-5537,1,1,1,20,169,7,196,,10.14356/kona.2021013
1339-9276,1,1,1,2,0,11,13,,10.2478/eual-2020-0002
2586-6052 2586-6060,1,1,1,0,3,0,3,,10.4266/acc.2020.00647
2586-6052 2586-6060,1,1,1,0,16,12,28,,10.4266/acc.2020.00444
2586-6052 2586-6060,1,1,1,0,2,3,5,,10.4266/acc.2020.00850
2586-6052 2586-6060,1,1,1,0,40,6,46,,10.4266/acc.2020.00521
0267-3843 2164-4527,1,1,1,0,32,13,45,,10.1080/02673843.2019.1674167
0267-3843 2164-4527,1,1,1,0,25,6,31,,10.1080/02673843.2019.1581069
0267-3843 2164-4527,1,1,1,0,44,23,67,,10.1080/02673843.2019.1601115
0267-3843 2164-4527,1,1,1,0,19,8,27,,10.1080/02673843.2019.1601116
0267-3843 2164-4527,1,1,1,0,31,4,35,,10.1080/02673843.2017.1337585
2222-6931,1,1,1,15,0,9,24,,10.5334/jeps.bq
2222-6931,1,1,1,8,0,10,18,,10.5334/jeps.444
2222-6931,1,1,1,35,0,5,40,,10.5334/jeps.375
2413-3183 2410-1516,1,1,1,0,20,7,27,,10.4102/aveh.v79i1.521
2053-6712,1,1,1,1,0,29,30,,10.5334/snr.134
2579-0153,1,1,1,18,0,9,27,,10.29024/jsim.46
0187-6961 2395-9134,1,1,1,7,0,10,17,,10.21670/ref.2118081
0187-6961 2395-9134,1,1,1,5,0,26,31,,10.21670/ref.2120083
2043-8087,1,1,1,0,26,2,28,,10.1177/2043808718824886
2043-8087,1,1,1,2,80,16,98,,10.1177/2043808719858559
1868-1034 1868-4882,1,1,1,0,32,15,47,,10.1177/1868103420905140
0372-4123 2415-8860,1,1,1,0,43,48,91,,10.15407/ukrbotj77.04.249
2288-8586,1,1,1,0,23,1,24,,10.1186/s40902-019-0209-1
0214-3038 1988-2971,1,1,1,0,0,37,37,,10.5209/ELEM.60006
0974-2727 0974-7826,1,1,1,0,0,10,10,,10.4103/0974-2727.72156
2515-8163,1,1,1,0,23,0,23,,10.1177/2515816318809697
2515-8163,1,1,1,0,63,10,73,,10.1177/2515816319884937
2515-8163,1,1,1,0,12,2,14,,10.1177/2515816318773772
2515-8163,1,1,1,0,8,2,10,,10.1177/2515816318768827
2572-9861,1,1,1,2,25,34,61,,10.1080/25729861.2019.1636620
2049-4572 1364-0429,1,1,1,0,0,2,2,,10.5334/jcms.210
2688-2663,1,1,1,4,4,0,8,,10.1002/mco2.44
2042-0986 2042-0994,1,1,1,0,28,0,28,,10.1177/2042098621998876
1342-078X 1347-4715,1,1,1,1,44,12,57,,10.1186/s12199-020-00849-6
1342-078X 1347-4715,1,1,1,15,14,17,46,,10.1186/s12199-021-00949-x
2183-4938,1,1,1,1,16,27,44,,10.7342/ismt.rpics.2017.3.2.52
2055-1029,1,1,1,0,138,22,160,,10.1177/2055102914564582
2055-1029,1,1,1,0,16,1,17,,10.1177/2055102918786865
1179-5441,1,1,1,0,20,6,26,,10.1177/1179544118757496
1179-5441,1,1,1,1,23,3,27,,10.1177/1179544117751431
2055-1169,1,1,1,3,20,5,28,,10.1177/2055116918760652
2055-1169,1,1,1,2,30,5,37,,10.1177/2055116918771767
1811-7465 2071-0437,1,1,1,1,2,15,18,,10.20874/2071-0437-2021-52-1-15
1811-7465 2071-0437,1,1,1,1,5,16,22,,10.20874/2071-0437-2021-52-1-18
1179-5565,1,1,1,2,11,2,15,,10.1177/1179556518784300
2199-3971 2199-398X,1,1,1,17,0,19,36,,10.5194/soil-6-325-2020
0120-131X 2389-9980,1,1,1,0,4,24,28,,10.18566/cueteo.v45n104.a05
2673-7647,1,1,1,1,51,2,54,,10.3389/fbinf.2021.742843
2318-0331,1,1,1,0,18,6,24,,10.1590/2318-0331.021720160018
2318-0331,1,1,1,3,0,4,7,,10.1590/2318-0331.011615094
2363-9075,1,1,1,2,0,18,20,,10.5334/fce.43
2363-9075,1,1,1,1,0,7,8,,10.5334/fce.83
2397-3269,1,1,1,7,10,2,19,,10.1136/bmjophth-2020-000513
2397-3269,1,1,1,18,25,8,51,,10.1136/bmjophth-2020-000483
2397-3269,1,1,1,37,11,9,57,,10.1136/bmjophth-2020-000563
2397-3269,1,1,1,18,14,3,35,,10.1136/bmjophth-2020-000538
2397-3269,1,1,1,11,10,2,23,,10.1136/bmjophth-2020-000446
2397-3269,1,1,1,3,14,3,20,,10.1136/bmjophth-2019-000424
1809-9823 1981-2256,1,1,1,16,0,15,31,,10.1590/1809-9823.200912012
1809-9823 1981-2256,1,1,1,6,0,14,20,,10.1590/1809-9823.2008.11034
1809-9823 1981-2256,1,1,1,5,0,23,28,,10.1590/S1809-98232011000300003
1809-9823 1981-2256,1,1,1,4,0,17,21,,10.1590/S1809-98232011000200005
1809-9823 1981-2256,1,1,1,20,0,9,29,,10.1590/1809-98232016019.150226
1809-9823 1981-2256,1,1,1,5,0,19,24,,10.1590/1809-9823.2016.15011
1809-9823 1981-2256,1,1,1,13,0,22,35,,10.1590/1809-9823.2016.14175
1809-9823 1981-2256,1,1,1,33,0,11,44,,10.1590/1809-98232016019.150040
2083-6007,1,1,1,0,24,9,33,,10.31883/pjfns/109280
1230-2384 2300-2611,1,1,1,7,0,4,11,,10.1515/acsc-2015-0028
1981-6472,1,1,1,2,55,22,79,,10.5964/ijpr.v7i1.109
1981-6472,1,1,1,0,27,11,38,,10.5964/ijpr.v8i2.166
2571-9394,1,1,1,0,22,5,27,,10.3390/forecast3010014
2571-9394,1,1,1,2,52,19,73,,10.3390/forecast3010012
2311-6706 2150-5551,1,1,1,0,49,0,49,,10.1007/s40820-019-0278-9
2311-6706 2150-5551,1,1,1,0,109,0,109,,10.1007/s40820-019-0309-6
2000-4214,1,1,1,2,25,39,66,,10.1080/20004214.2019.1682224
0867-5856 2080-6922,1,1,1,3,0,36,39,,10.2478/tour-2019-0003
0867-5856 2080-6922,1,1,1,0,0,15,15,,10.18778/0867-5856.27.2.03
0867-5856 2080-6922,1,1,1,0,0,22,22,,10.1515/tour-2017-0015
0867-5856 2080-6922,1,1,1,8,0,18,26,,10.18778/0867-5856.26.1.03
0867-5856 2080-6922,1,1,1,21,0,49,70,,10.1515/tour-2017-0009
0867-5856 2080-6922,1,1,1,23,0,12,35,,10.18778/0867-5856.31.1.20
2197-1927,1,1,1,0,4,4,8,,10.1186/s40604-018-0056-6
1470-3203 1752-8976,1,1,1,3,8,8,19,,10.3317/jraas.2007.012
1470-3203 1752-8976,1,1,1,1,4,3,8,,10.3317/jraas.2001.008
1470-3203 1752-8976,1,1,1,0,33,1,34,,10.1177/1470320311434818
1470-3203 1752-8976,1,1,1,1,8,4,13,,10.3317/jraas.2004.031
1470-3203 1752-8976,1,1,1,0,39,4,43,,10.1177/1470320312450531
1470-3203 1752-8976,1,1,1,0,36,3,39,,10.3317/jraas.2006.024
1470-3203 1752-8976,1,1,1,6,149,36,191,,10.3317/jraas.2000.034
1470-3203 1752-8976,1,1,1,0,27,3,30,,10.1177/1470320314568439
1470-3203 1752-8976,1,1,1,4,64,12,80,,10.3317/jraas.2004.035
1470-3203 1752-8976,1,1,1,0,5,1,6,,10.3317/jraas.2001.016
1470-3203 1752-8976,1,1,1,0,20,0,20,,10.1177/1470320315576256
1470-3203 1752-8976,1,1,1,0,18,8,26,,10.3317/jraas.2007.016
1470-3203 1752-8976,1,1,1,0,6,0,6,,10.1177/1470320313485895
1470-3203 1752-8976,1,1,1,0,35,3,38,,10.1177/1470320309360816
1470-3203 1752-8976,1,1,1,0,20,4,24,,10.1177/1470320314566017
1470-3203 1752-8976,1,1,1,1,35,0,36,,10.1177/1470320312446212
1470-3203 1752-8976,1,1,1,2,43,7,52,,10.1177/1470320311408750
1470-3203 1752-8976,1,1,1,0,19,5,24,,10.3317/jraas.2002.013
1470-3203 1752-8976,1,1,1,2,32,6,40,,10.3317/jraas.2002.010
1470-3203 1752-8976,1,1,1,1,15,3,19,,10.3317/jraas.2001.014
1470-3203 1752-8976,1,1,1,1,28,3,32,,10.1177/1470320310390405
1470-3203 1752-8976,1,1,1,3,69,14,86,,10.3317/jraas.2000.001
1470-3203 1752-8976,1,1,1,0,38,2,40,,10.1177/1470320315599514
1470-3203 1752-8976,1,1,1,0,27,3,30,,10.1177/1470320309104067
1470-3203 1752-8976,1,1,1,0,22,3,25,,10.1177/1470320310376554
1470-3203 1752-8976,1,1,1,0,31,5,36,,10.1177/1470320320981316
1470-3203 1752-8976,1,1,1,0,7,6,13,,10.3317/jraas.2000.052
1470-3203 1752-8976,1,1,1,0,25,3,28,,10.1177/1470320313502105
1470-3203 1752-8976,1,1,1,0,34,6,40,,10.1177/1470320320907820
1470-3203 1752-8976,1,1,1,7,61,7,75,,10.1177/1470320312452766
1470-3203 1752-8976,1,1,1,0,19,2,21,,10.1177/1470320320972276
1470-3203 1752-8976,1,1,1,0,57,13,70,,10.3317/jraas.2001.019
1470-3203 1752-8976,1,1,1,0,36,1,37,,10.3317/jraas.2006.044
1470-3203 1752-8976,1,1,1,0,16,7,23,,10.3317/jraas.2001.021
1470-3203 1752-8976,1,1,1,0,37,9,46,,10.1177/1470320316678159
1470-3203 1752-8976,1,1,1,0,18,1,19,,10.3317/jraas.2008.014
1470-3203 1752-8976,1,1,1,1,26,12,39,,10.3317/jraas.2007.030
1470-3203 1752-8976,1,1,1,2,44,9,55,,10.3317/jraas.2005.015
1470-3203 1752-8976,1,1,1,2,44,4,50,,10.1177/1470320308353059
2398-8835,1,1,1,0,44,4,48,,10.1002/hsr2.155
2398-8835,1,1,1,0,42,3,45,,10.1002/hsr2.169
2409-515X,1,1,1,3,75,12,90,,10.3390/ijns5020020
2409-515X,1,1,1,1,23,2,26,,10.3390/ijns7020021
2409-515X,1,1,1,1,29,12,42,,10.3390/ijns7010015
2046-2441,1,1,1,0,62,2,64,,10.1098/rsob.200304
2046-2441,1,1,1,0,115,7,122,,10.1098/rsob.200411
0120-789X 2027-0119,1,1,1,6,1,1,8,,10.1055/s-0040-1712111
2059-5131,1,1,1,0,28,1,29,,10.1177/2059513120988532
2059-5131,1,1,1,0,28,7,35,,10.1177/2059513118808773
2434-4931,1,1,1,16,0,9,25,,10.1539/eohp.2020-0007-OA
1607-7970 2218-1903,1,1,1,0,5,4,9,,10.15407/techned2020.05.084
1607-7970 2218-1903,1,1,1,0,3,9,12,,10.15407/techned2020.01.003
1607-7970 2218-1903,1,1,1,0,1,6,7,,10.15407/techned2021.02.077
1607-7970 2218-1903,1,1,1,0,1,2,3,,10.15407/techned2021.02.042
1607-7970 2218-1903,1,1,1,0,0,9,9,,10.15407/techned2021.02.047
1607-7970 2218-1903,1,1,1,0,6,4,10,,10.15407/techned2020.04.029
1399-1183 2193-3081,1,1,1,3,0,4,7,,10.5194/we-15-43-2015
1178-5608,1,1,1,8,0,12,20,,10.21307/ijssis-2017-558
1178-5608,1,1,1,16,0,9,25,,10.21307/ijssis-2017-951
1178-5608,1,1,1,19,0,1,20,,10.21307/ijssis-2017-674
1178-5608,1,1,1,2,0,13,15,,10.21307/ijssis-2017-309
1178-5608,1,1,1,12,0,0,12,,10.21307/ijssis-2019-029
1178-5608,1,1,1,10,0,1,11,,10.21307/ijssis-2019-084
1178-5608,1,1,1,13,0,4,17,,10.21307/ijssis-2017-439
1178-5608,1,1,1,26,0,10,36,,10.21307/ijssis-2017-826
1178-5608,1,1,1,36,0,1,37,,10.21307/ijssis-2017-785
1178-5608,1,1,1,5,0,14,19,,10.21307/ijssis-2017-295
1178-5608,1,1,1,15,0,4,19,,10.21307/ijssis-2019-089
1178-5608,1,1,1,4,0,9,13,,10.21307/ijssis-2019-092
1178-5608,1,1,1,9,0,7,16,,10.21307/ijssis-2020-006
1178-5608,1,1,1,10,0,3,13,,10.21307/ijssis-2017-675
1178-5608,1,1,1,41,0,9,50,,10.21307/ijssis-2017-864
1178-5608,1,1,1,19,0,7,26,,10.21307/ijssis-2017-735
1178-5608,1,1,1,25,0,1,26,,10.21307/ijssis-2017-338
1178-5608,1,1,1,1,0,4,5,,10.21307/ijssis-2019-106
1178-5608,1,1,1,33,0,5,38,,10.21307/ijssis-2017-922
1178-5608,1,1,1,7,0,13,20,,10.21307/ijssis-2017-926
1178-5608,1,1,1,15,0,10,25,,10.21307/ijssis-2017-940
1178-5608,1,1,1,17,0,9,26,,10.21307/ijssis-2017-783
1178-5608,1,1,1,12,0,3,15,,10.21307/ijssis-2017-407
1178-5608,1,1,1,28,0,30,58,,10.21307/ijssis-2017-617
1178-5608,1,1,1,20,0,6,26,,10.21307/ijssis-2017-779
1178-5608,1,1,1,16,0,25,41,,10.21307/ijssis-2018-017
1178-5608,1,1,1,23,0,1,24,,10.21307/ijssis-2019-002
1178-5608,1,1,1,14,0,3,17,,10.21307/ijssis-2017-814
1178-5608,1,1,1,16,0,6,22,,10.21307/ijssis-2017-653
1178-5608,1,1,1,16,0,8,24,,10.21307/ijssis-2017-660
1178-5608,1,1,1,6,0,21,27,,10.21307/ijssis-2017-389
1178-5608,1,1,1,22,0,8,30,,10.21307/ijssis-2017-412
1178-5608,1,1,1,11,0,4,15,,10.21307/ijssis-2017-339
2287-8572 2287-8580,1,1,1,0,25,2,27,,10.5468/ogs.2020.63.3.225
2287-8572 2287-8580,1,1,1,26,0,1,27,,10.5468/ogs.2019.62.2.103
2287-8572 2287-8580,1,1,1,12,0,3,15,,10.5468/ogs.2019.62.4.258
2287-8572 2287-8580,1,1,1,24,0,11,35,,10.5468/ogs.2019.62.4.264
2287-8572 2287-8580,1,1,1,11,0,4,15,,10.5468/ogs.2019.62.4.294
2287-8572 2287-8580,1,1,1,30,0,3,33,,10.5468/ogs.2019.62.1.11
2287-8572 2287-8580,1,1,1,14,0,0,14,,10.5468/ogs.2019.62.5.357
1998-6041 1998-605X,1,1,1,3,7,41,51,,10.21511/ee.11(1).2020.04
1420-4096 1423-0143,1,1,1,0,14,0,14,,10.1159/000520894
1420-4096 1423-0143,1,1,1,0,0,26,26,,10.1159/000508078
2300-2506,1,1,1,0,0,2,2,,10.1515/aee-2015-0002
1308-8793 1308-8815,1,1,1,4,0,5,9,,10.33818/ier.687042
1178-8690,1,1,1,7,0,17,24,,10.21307/jelpp-2017-006
2179-1074,1,1,1,29,0,8,37,,10.1590/2179-10742020v19i2824
2179-1074,1,1,1,14,0,9,23,,10.1590/2179-10742019v18i31497
2179-1074,1,1,1,8,0,8,16,,10.1590/2179-10742019v18i31628
2047-2382,1,1,1,4,145,23,172,,10.1186/s13750-020-00196-7
2047-2382,1,1,1,4,30,16,50,,10.1186/s13750-021-00248-6
2047-2382,1,1,1,1,22,17,40,,10.1186/s13750-021-00247-7
1177-9322,1,1,1,1,55,9,65,,10.1177/1177932218759292
1177-9322,1,1,1,0,27,5,32,,10.1177/1177932219850172
1177-9322,1,1,1,0,28,2,30,,10.1177/1177932219838851
1177-9322,1,1,1,0,51,3,54,,10.1177/11779322211009199
1177-9322,1,1,1,1,56,4,61,,10.1177/1177932220965505
2309-4990,1,1,1,0,25,3,28,,10.1177/23094990211061610
2309-4990,1,1,1,0,25,4,29,,10.1177/23094990211055226
2309-4990,1,1,1,0,8,0,8,,10.1177/230949901402200337
2309-4990,1,1,1,1,27,6,34,,10.1177/2309499019874413
2309-4990,1,1,1,1,24,4,29,,10.1177/2309499020923093
2309-4990,1,1,1,1,29,11,41,,10.1177/23094990211055224
2309-4990,1,1,1,0,30,5,35,,10.1177/23094990211061209
2309-4990,1,1,1,0,39,1,40,,10.1177/23094990211055867
1989-9068,1,1,1,0,31,3,34,,10.4995/wpom.v11i1.12891
1000-2758 2609-7125,1,1,1,5,0,6,11,,10.1051/jnwpu/20183661162
1000-2758 2609-7125,1,1,1,10,0,5,15,,10.1051/jnwpu/20183650995
1000-2758 2609-7125,1,1,1,12,0,5,17,,10.1051/jnwpu/20193750897
1000-2758 2609-7125,1,1,1,7,0,9,16,,10.1051/jnwpu/20183630565
1000-2758 2609-7125,1,1,1,6,0,7,13,,10.1051/jnwpu/20183610042
1000-2758 2609-7125,1,1,1,8,0,3,11,,10.1051/jnwpu/20193761285
1000-2758 2609-7125,1,1,1,14,0,4,18,,10.1051/jnwpu/20183640627
1000-2758 2609-7125,1,1,1,5,0,8,13,,10.1051/jnwpu/20193761158
1000-2758 2609-7125,1,1,1,12,0,5,17,,10.1051/jnwpu/20193761238
1000-2758 2609-7125,1,1,1,10,0,1,11,,10.1051/jnwpu/20193761278
1000-2758 2609-7125,1,1,1,12,0,7,19,,10.1051/jnwpu/20183610066
1000-2758 2609-7125,1,1,1,5,0,7,12,,10.1051/jnwpu/20183620281
1000-2758 2609-7125,1,1,1,7,0,6,13,,10.1051/jnwpu/20203810048
1000-2758 2609-7125,1,1,1,5,0,5,10,,10.1051/jnwpu/20203810170
1000-2758 2609-7125,1,1,1,12,0,9,21,,10.1051/jnwpu/20193750878
1000-2758 2609-7125,1,1,1,1,0,14,15,,10.1051/jnwpu/20193710093
1000-2758 2609-7125,1,1,1,8,0,11,19,,10.1051/jnwpu/20193720232
1000-2758 2609-7125,1,1,1,7,0,6,13,,10.1051/jnwpu/20193720299
1000-2758 2609-7125,1,1,1,10,0,0,10,,10.1051/jnwpu/20193761320
1000-2758 2609-7125,1,1,1,5,0,8,13,,10.1051/jnwpu/20203851018
1000-2758 2609-7125,1,1,1,16,0,17,33,,10.1051/jnwpu/20203851054
1000-2758 2609-7125,1,1,1,12,0,7,19,,10.1051/jnwpu/20203840774
1000-2758 2609-7125,1,1,1,9,0,16,25,,10.1051/jnwpu/20203840889
1000-2758 2609-7125,1,1,1,8,0,7,15,,10.1051/jnwpu/20203820392
0040-3660 2309-5342,1,1,1,25,0,5,30,,10.17116/terarkh2017899100-103
0040-3660 2309-5342,1,1,1,0,15,14,29,,10.17116/terarkh201789365-71
0040-3660 2309-5342,1,1,1,1,25,3,29,,10.26442/00403660.2019.10.000095
0040-3660 2309-5342,1,1,1,1,1,5,7,,10.26442/00403660.2019.12.000451
2036-3605 2036-3613,1,1,1,0,27,1,28,,10.1177/20363613211044690
2036-3605 2036-3613,1,1,1,0,14,4,18,,10.1177/20363613211009769
2036-3605 2036-3613,1,1,1,0,12,1,13,,10.4081/rt.2011.e51
2036-3605 2036-3613,1,1,1,0,11,0,11,,10.4081/rt.2009.e37
2036-3605 2036-3613,1,1,1,0,8,3,11,,10.4081/rt.2012.e5
2036-3605 2036-3613,1,1,1,0,17,2,19,,10.1177/20363613211029487
2036-3605 2036-3613,1,1,1,0,9,0,9,,10.1177/20363613211028498
1733-8069,1,1,1,2,1,11,14,,10.18778/1733-8069.16.2.03
2475-0328,1,1,1,0,39,2,41,,10.1002/ags3.12242
2475-0328,1,1,1,0,29,2,31,,10.1002/ags3.12347
2475-0328,1,1,1,0,27,0,27,,10.1002/ags3.12335
2475-0328,1,1,1,0,31,1,32,,10.1002/ags3.12328
1756-2872 1756-2880,1,1,1,0,20,2,22,,10.1177/17562872211058243
1756-2872 1756-2880,1,1,1,0,26,4,30,,10.1177/1756287212437361
1756-2872 1756-2880,1,1,1,0,12,3,15,,10.1177/1756287221997183
2475-8876,1,1,1,0,1,7,8,,10.1002/2475-8876.1006
2475-8876,1,1,1,0,3,10,13,,10.1002/2475-8876.12172
2475-8876,1,1,1,1,0,10,11,,10.1002/2475-8876.12147
1010-4283 1423-0380,1,1,1,0,27,3,30,,10.1177/1010428317705335
1010-4283 1423-0380,1,1,1,46,0,2,48,,10.1177/1010428317701442
1010-4283 1423-0380,1,1,1,28,0,2,30,,10.1177/1010428317706054
1010-4283 1423-0380,1,1,1,0,49,2,51,,10.1177/1010428317695023
1010-4283 1423-0380,1,1,1,10,0,1,11,,10.1177/1010428317713390
1010-4283 1423-0380,1,1,1,0,33,2,35,,10.1177/1010428317691429
1010-4283 1423-0380,1,1,1,0,29,2,31,,10.1177/1010428317717670
1010-4283 1423-0380,1,1,1,45,0,0,45,,10.1177/1010428317727479
1010-4283 1423-0380,1,1,1,0,36,3,39,,10.1177/1010428317695939
1010-4283 1423-0380,1,1,1,0,17,1,18,,10.1177/1010428317716250
1010-4283 1423-0380,1,1,1,0,33,1,34,,10.1177/1010428317694312
1010-4283 1423-0380,1,1,1,0,31,4,35,,10.1177/1010428318776170
1010-4283 1423-0380,1,1,1,0,25,1,26,,10.1177/1010428317690998
1010-4283 1423-0380,1,1,1,0,133,9,142,,10.1177/1010428317695525
1010-4283 1423-0380,1,1,1,0,45,4,49,,10.1177/1010428318808678
1010-4283 1423-0380,1,1,1,27,3,3,33,,10.1177/1010428317701636
1010-4283 1423-0380,1,1,1,72,0,6,78,,10.1177/1010428318799255
1010-4283 1423-0380,1,1,1,20,3,5,28,,10.1177/1010428317709467
1010-4283 1423-0380,1,1,1,54,2,3,59,,10.1177/1010428317728285
1010-4283 1423-0380,1,1,1,1,31,1,33,,10.1177/1010428317694549
1010-4283 1423-0380,1,1,1,0,37,1,38,,10.1177/1010428317692233
1010-4283 1423-0380,1,1,1,38,0,10,48,,10.1177/1010428317711662
1010-4283 1423-0380,1,1,1,0,25,2,27,,10.1177/1010428317694572
1010-4283 1423-0380,1,1,1,0,33,1,34,,10.1177/1010428317711315
1010-4283 1423-0380,1,1,1,0,56,3,59,,10.1177/1010428317698375
1010-4283 1423-0380,1,1,1,62,0,10,72,,10.1177/1010428317709640
1010-4283 1423-0380,1,1,1,0,27,0,27,,10.1177/1010428317695030
1010-4283 1423-0380,1,1,1,0,24,1,25,,10.1177/1010428317695947
1010-4283 1423-0380,1,1,1,3,149,6,158,,10.1177/1010428317692259
1010-4283 1423-0380,1,1,1,0,27,5,32,,10.1177/1010428317695926
1010-4283 1423-0380,1,1,1,0,49,5,54,,10.1177/1010428317692232
1010-4283 1423-0380,1,1,1,1,41,10,52,,10.1177/1010428317717259
1010-4283 1423-0380,1,1,1,28,2,1,31,,10.1177/1010428317734865
1010-4283 1423-0380,1,1,1,0,109,11,120,,10.1177/1010428318760342
1010-4283 1423-0380,1,1,1,1,54,6,61,,10.1177/1010428317695019
2331-205X,1,1,1,0,22,2,24,,10.1080/2331205X.2017.1304512
2331-205X,1,1,1,1,27,3,31,,10.1080/2331205X.2017.1314905
2331-205X,1,1,1,0,25,9,34,,10.1080/2331205X.2017.1320848
2331-205X,1,1,1,0,10,1,11,,10.1080/2331205X.2017.1362185
2331-205X,1,1,1,0,35,8,43,,10.1080/2331205X.2015.1134041
2331-205X,1,1,1,0,24,3,27,,10.1080/2331205X.2016.1211594
2331-205X,1,1,1,0,15,9,24,,10.1080/2331205X.2016.1233685
2331-205X,1,1,1,1,11,2,14,,10.1080/2331205X.2016.1257410
2331-205X,1,1,1,0,12,2,14,,10.1080/2331205X.2016.1269628
2331-205X,1,1,1,0,39,5,44,,10.1080/2331205X.2017.1389257
2331-205X,1,1,1,0,27,5,32,,10.1080/2331205X.2017.1389639
2331-205X,1,1,1,1,31,9,41,,10.1080/2331205X.2017.1403728
2331-205X,1,1,1,0,27,4,31,,10.1080/2331205X.2018.1461005
2331-205X,1,1,1,0,25,5,30,,10.1080/2331205X.2018.1483096
2331-205X,1,1,1,0,28,3,31,,10.1080/2331205X.2018.1486783
2331-205X,1,1,1,0,26,0,26,,10.1080/2331205X.2018.1512352
2331-205X,1,1,1,0,24,70,94,,10.1080/2331205X.2018.1513349
2331-205X,1,1,1,0,23,15,38,,10.1080/2331205X.2018.1531459
0886-022X 1525-6049,1,1,1,1,30,8,39,,10.1080/0886022X.2020.1748650
0886-022X 1525-6049,1,1,1,0,25,2,27,,10.1080/0886022X.2020.1762646
0886-022X 1525-6049,1,1,1,0,6,0,6,,10.1080/0886022X.2020.1776734
0886-022X 1525-6049,1,1,1,0,43,1,44,,10.1080/0886022X.2020.1788582
0886-022X 1525-6049,1,1,1,0,18,0,18,,10.1080/0886022X.2020.1803085
0886-022X 1525-6049,1,1,1,0,29,2,31,,10.1080/0886022X.2020.1818578
1742-9145 1742-9153,1,1,1,0,75,8,83,,10.1080/17429145.2019.1609106
1742-9145 1742-9153,1,1,1,0,38,6,44,,10.1080/17429145.2018.1547843
1742-9145 1742-9153,1,1,1,0,38,27,65,,10.1080/17429145.2018.1550217
1742-9145 1742-9153,1,1,1,0,67,11,78,,10.1080/17429145.2019.1662101
1742-9145 1742-9153,1,1,1,0,59,14,73,,10.1080/17429145.2018.1556356
1751-8253 1751-7192,1,1,1,1,42,6,49,,10.1080/17518253.2020.1856426
1751-8253 1751-7192,1,1,1,1,42,7,50,,10.1080/17518253.2021.1876172
2331-1908,1,1,1,0,27,6,33,,10.1080/23311908.2016.1149264
2331-1908,1,1,1,0,25,12,37,,10.1080/23311908.2016.1152759
2331-1908,1,1,1,0,34,16,50,,10.1080/23311908.2016.1162414
2331-1908,1,1,1,0,13,6,19,,10.1080/23311908.2016.1164931
2331-1908,1,1,1,0,36,16,52,,10.1080/23311908.2016.1264657
2162-402X,1,1,1,0,43,5,48,,10.1080/2162402X.2017.1333214
2162-402X,1,1,1,0,20,0,20,,10.1080/2162402X.2017.1334027
2162-402X,1,1,1,0,44,0,44,,10.1080/2162402X.2017.1345402
2162-402X,1,1,1,0,50,2,52,,10.1080/2162402X.2017.1296996
2162-402X,1,1,1,0,58,2,60,,10.1080/2162402X.2018.1490854
2162-402X,1,1,1,0,66,1,67,,10.1080/2162402X.2018.1537693
2162-402X,1,1,1,0,47,0,47,,10.1080/2162402X.2019.1644108
2162-402X,1,1,1,1,38,1,40,,10.1080/2162402X.2019.1638210
2162-402X,1,1,1,0,72,0,72,,10.1080/2162402X.2017.1305531
2162-402X,1,1,1,0,57,4,61,,10.1080/2162402X.2019.1586042
2162-402X,1,1,1,1,76,7,84,,10.1080/2162402X.2019.1593806
2162-402X,1,1,1,0,0,10,10,,10.1080/2162402X.2019.1599639
2162-402X,1,1,1,1,233,10,244,,10.1080/2162402X.2018.1526250
2162-402X,1,1,1,0,62,6,68,,10.1080/2162402X.2017.1409929
2162-402X,1,1,1,1,39,2,42,,10.1080/2162402X.2018.1438106
2162-402X,1,1,1,0,39,1,40,,10.1080/2162402X.2018.1434466
2162-402X,1,1,1,1,45,3,49,,10.1080/2162402X.2018.1471440
2162-402X,1,1,1,0,30,0,30,,10.1080/2162402X.2018.1502130
2162-402X,1,1,1,0,27,1,28,,10.1080/2162402X.2018.1494488
2162-402X,1,1,1,0,49,4,53,,10.1080/2162402X.2019.1661194
2162-402X,1,1,1,0,31,0,31,,10.1080/2162402X.2018.1550619
2162-402X,1,1,1,0,45,3,48,,10.1080/2162402X.2018.1558663
2162-402X,1,1,1,0,54,1,55,,10.1080/2162402X.2019.1581545
2162-402X,1,1,1,0,30,1,31,,10.1080/2162402X.2019.1601480
2162-402X,1,1,1,0,115,2,117,,10.1080/2162402X.2019.1633235
2162-402X,1,1,1,0,43,0,43,,10.1080/2162402X.2019.1638207
2162-402X,1,1,1,0,23,0,23,,10.1080/2162402X.2019.1665977
1880-6791 1880-6805,1,1,1,50,0,5,55,,10.1186/s40101-020-00225-x
2198-4018 2198-4026,1,1,1,34,21,21,76,,10.1186/s40708-020-00104-2
2279-7254,1,1,1,0,42,27,69,,10.1080/22797254.2020.1811776
2279-7254,1,1,1,0,6,6,12,,10.1080/22797254.2020.1771214
2279-7254,1,1,1,0,14,8,22,,10.1080/22797254.2020.1801356
2279-7254,1,1,1,0,22,5,27,,10.1080/22797254.2020.1758964
2279-7254,1,1,1,0,18,2,20,,10.1080/22797254.2020.1765202
2574-2558,1,1,1,0,12,17,29,,10.1080/25742558.2018.1458553
2574-2558,1,1,1,0,5,6,11,,10.1080/25742558.2018.1492338
2574-2558,1,1,1,0,11,2,13,,10.1080/25742558.2019.1588191
2574-2558,1,1,1,0,12,19,31,,10.1080/25742558.2020.1761001
2574-2558,1,1,1,0,10,13,23,,10.1080/25742558.2020.1788298
2587-9332,1,1,1,0,0,13,13,,10.14258/leglin(2019)1404
1940-0632 1940-0640,1,1,1,1,48,13,62,,10.1186/s13722-019-0141-9
2213-5960,1,1,1,7,0,1,8,,10.1016/j.gdata.2016.12.012
2213-5960,1,1,1,4,0,0,4,,10.1016/j.gdata.2015.09.019
2213-5960,1,1,1,20,0,3,23,,10.1016/j.gdata.2016.03.003
2213-5960,1,1,1,36,0,1,37,,10.1016/j.gdata.2014.06.010
2213-5960,1,1,1,12,0,2,14,,10.1016/j.gdata.2016.03.007
2213-5960,1,1,1,5,0,1,6,,10.1016/j.gdata.2015.05.042
2213-5960,1,1,1,9,0,1,10,,10.1016/j.gdata.2016.06.016
2213-5960,1,1,1,20,0,4,24,,10.1016/j.gdata.2016.09.013
2631-4797,1,1,1,71,0,4,75,,10.1093/asjof/ojab007
2631-4797,1,1,1,25,0,8,33,,10.1093/asjof/ojab036
2631-4797,1,1,1,9,0,4,13,,10.1093/asjof/ojab034
2624-7402,1,1,1,0,14,13,27,,10.3390/agriengineering3020015
1803-3857,1,1,1,0,2,34,36,,10.5507/euj.2012.002
1803-3857,1,1,1,0,23,14,37,,10.5507/euj.2012.003
1803-3857,1,1,1,0,22,8,30,,10.5507/euj.2011.003
1803-3857,1,1,1,2,23,8,33,,10.5507/euj.2012.009
1803-3857,1,1,1,0,26,11,37,,10.5507/euj.2019.008
1880-7062,1,1,1,1,18,3,22,,10.1186/s41021-018-0112-5
1880-7062,1,1,1,1,28,6,35,,10.1186/s41021-021-00184-4
1880-7062,1,1,1,57,0,4,61,,10.1186/s41021-021-00228-9
2522-1663 2524-2679,1,1,1,0,0,14,14,,10.29038/2524-2679-2020-01-93-104
2522-1663 2524-2679,1,1,1,0,0,10,10,,10.29038/2524-2679-2017-02-67-77
2522-1663 2524-2679,1,1,1,0,0,11,11,,10.29038/2524-2679-2017-01-96-108
2522-1663 2524-2679,1,1,1,0,3,11,14,,10.29038/2524-2679-2020-01-40-52
2522-1663 2524-2679,1,1,1,0,0,18,18,,10.29038/2524-2679-2018-02-126-136
2522-1663 2524-2679,1,1,1,0,0,9,9,,10.29038/2524-2679-2017-01-14-22
2522-1663 2524-2679,1,1,1,0,0,14,14,,10.29038/2524-2679-2019-02-05-16
2475-0360,1,1,1,0,2,10,12,,10.1002/agm2.12107
2398-7324,1,1,1,0,24,2,26,,10.1002/pro6.1092
2165-2627,1,1,1,5,0,31,36,,10.5334/sta.fs
2110-6134,1,1,1,0,7,0,7,,10.4000/transposition.1182
2766-1652,1,1,1,2,30,7,39,,10.37016/mr-2020-50
2766-1652,1,1,1,0,13,11,24,,10.37016/mr-2020-46
2766-1652,1,1,1,0,4,19,23,,10.37016/mr-2020-40
2766-1652,1,1,1,1,7,18,26,,10.37016/mr-2020-51
1661-8556 1661-8564,1,1,1,0,34,1,35,,10.3389/ijph.2021.585801
0138-0680 2449-836X,1,1,1,5,0,11,16,,10.18778/0138-0680.2020.20
1687-9481 1687-949X,1,1,1,11,18,17,46,,10.1155/2014/241410
1687-6334 1687-6342,1,1,1,0,32,5,37,,10.1155/2015/418673
2321-3876,1,1,1,0,3,1,4,,10.1186/s41038-019-0170-3
2500-1574 2500-1582,1,1,1,18,0,1,19,,10.21285/2500-1582-2021-1-103-113
2500-1574 2500-1582,1,1,1,0,0,13,13,,10.21285/2500-1582-2021-3-266-277
2500-1574 2500-1582,1,1,1,10,0,3,13,,10.21285/2500-1582-2021-3-309-318
1413-9936 1981-5344,1,1,1,3,0,34,37,,10.1590/1981-5344/4144
1413-7755 2316-8242,1,1,1,0,0,10,10,,10.1590/2316-82422015v3602almi
2194-1459 2194-1467,1,1,1,45,1,2,48,,10.1007/s40243-020-00174-6
1752-8054 1752-8062,1,1,1,0,10,9,19,,10.1111/cts.12737
2571-905X,1,1,1,1,41,6,48,,10.3390/stats3030022
2571-905X,1,1,1,0,14,10,24,,10.3390/stats4020021
2571-905X,1,1,1,0,21,22,43,,10.3390/stats4020030
2571-905X,1,1,1,0,20,7,27,,10.3390/stats4020020
1748-7188,1,1,1,8,15,7,30,,10.1186/s13015-017-0102-3
1748-7188,1,1,1,0,29,3,32,,10.1186/s13015-021-00202-8
0018-0661 1601-5223,1,1,1,2,25,14,41,,10.1186/s41065-017-0043-3
2190-4715,1,1,1,0,39,9,48,,10.1186/s12302-018-0148-y
2190-4715,1,1,1,0,16,7,23,,10.1186/s12302-018-0159-8
1958-5322,1,1,1,0,7,0,7,,10.4000/cognitextes.356
2189-7948,1,1,1,7,26,4,37,,10.1002/jgf2.410
1755-263X,1,1,1,0,58,5,63,,10.1111/conl.12781
1755-263X,1,1,1,0,29,7,36,,10.1111/conl.12679
1755-263X,1,1,1,4,33,4,41,,10.1111/conl.12783
1755-263X,1,1,1,37,0,13,50,,10.1111/conl.12788
1755-263X,1,1,1,2,75,10,87,,10.1111/conl.12652
2306-2908,1,1,1,1,2,24,27,,10.31861/pytlit2020.102.088
2076-1333 2312-1130,1,1,1,1,2,28,31,,https://doi.org/10.26565/2076-1333-2020-29-05
2045-1253 2045-1261,1,1,1,0,30,1,31,,10.1177/20451253211006508
1747-0161 2047-6094,1,1,1,0,13,1,14,,10.1177/1747016120969743
1747-0161 2047-6094,1,1,1,0,12,1,13,,10.1177/1747016120943635
1747-0161 2047-6094,1,1,1,0,28,10,38,,10.1177/17470161211045557
1759-0914,1,1,1,1,113,11,125,,10.1177/17590914211055064
1759-0914,1,1,1,0,55,2,57,,10.1177/1759091421991769
2048-0040,1,1,1,0,19,1,20,,10.1177/20480040211047122
2048-0040,1,1,1,1,33,2,36,,10.1177/2048004021992190
2009-4078,1,1,1,28,0,28,56,,https://doi.org/10.33178/alpha.18.08
2009-4078,1,1,1,0,0,3,3,,https://doi.org/10.33178/alpha.19.03
2009-4078,1,1,1,0,0,6,6,,https://doi.org/10.33178/alpha.19.08
2009-4078,1,1,1,0,0,2,2,,https://doi.org/10.33178/alpha.20.15
2073-8684 2409-7004,1,1,1,0,8,19,27,,10.15673/fst.v14i2.1717
2054-1058,1,1,1,1,35,4,40,,10.1002/nop2.746
2054-1058,1,1,1,0,45,21,66,,10.1002/nop2.727
2054-1058,1,1,1,0,55,13,68,,10.1002/nop2.654
2054-1058,1,1,1,0,22,3,25,,10.1002/nop2.711
2210-9099 2210-9110,1,1,1,0,18,2,20,,10.24171/j.phrp.2020.11.1.05
2196-8888 2196-8896,1,1,1,0,1,8,9,,10.1142/S2196888820500037
2520-257X 2617-3980,1,1,1,0,13,5,18,,10.33581/2520-257X-2019-1-14-21
2520-257X 2617-3980,1,1,1,57,0,5,62,,10.33581/2520-257X-2020-2-50-62
2688-4011,1,1,1,18,29,11,58,,10.1002/nano.202100012
2688-4011,1,1,1,4,41,2,47,,10.1002/nano.202000278
2688-4011,1,1,1,2,48,0,50,,10.1002/nano.202100004
2699-8440,1,1,1,1,40,22,63,,10.5964/sotrap.3067
2699-8440,1,1,1,0,7,15,22,,10.5964/sotrap.3125
2699-8440,1,1,1,5,56,13,74,,10.5964/sotrap.4283
2699-8440,1,1,1,0,32,9,41,,10.5964/sotrap.3127
2699-8440,1,1,1,1,70,11,82,,10.5964/sotrap.3711
2214-5095,1,1,1,4,0,0,4,,10.1016/j.cscm.2015.10.005
2673-2726,1,1,1,9,25,66,100,,10.3389/fhumd.2021.668264
2673-2726,1,1,1,6,17,21,44,,10.3389/fhumd.2021.635809
2673-2726,1,1,1,10,70,22,102,,10.3389/fhumd.2021.652968
2673-2726,1,1,1,1,53,12,66,,10.3389/fhumd.2021.624727
0187-5337,1,1,1,3,0,20,23,,10.1016/j.rprh.2016.02.001
2288-9140 2671-7883,1,1,1,0,13,1,14,,10.46268/jsu.2021.8.2.32
0205-3640 2603-3186,1,1,1,3,3,13,19,,10.48027/hnb.43.061
2311-259X,1,1,1,0,1,34,35,,10.28925/2311-259x.2019.1.5
2300-8741 2544-994X,1,1,1,3,10,13,26,,10.35467/sdq/103181
2300-8741 2544-994X,1,1,1,0,0,31,31,,10.5604/01.3001.0012.7844
2300-8741 2544-994X,1,1,1,2,4,28,34,,10.35467/sdq/110018
2300-8741 2544-994X,1,1,1,0,6,3,9,,10.35467/sdq/125295
2548-0499,1,1,1,0,1,19,20,,10.30927/ijpf.534569
2398-3795,1,1,1,2,33,10,45,,10.3399/bjgpopen18X101595
2398-3795,1,1,1,1,11,23,35,,10.3399/BJGPO.2020.0151
2398-3795,1,1,1,0,16,3,19,,10.3399/bjgpopen20X101124
2398-3795,1,1,1,0,30,9,39,,10.3399/bjgpopen20X101131
2057-4967,1,1,1,1,19,3,23,,10.1186/s41016-021-00236-2
2057-4967,1,1,1,1,45,6,52,,10.1186/s41016-021-00267-9
2057-4967,1,1,1,3,17,0,20,,10.1186/s41016-021-00238-0
2643-1092,1,1,1,14,32,15,61,,10.3934/GF.2021002
2643-1092,1,1,1,16,38,16,70,,10.3934/GF.2021008
2643-1092,1,1,1,30,0,3,33,,10.3934/GF.2021012
2522-9699 2616-5007,1,1,1,0,0,10,10,,10.33930/ed.2019.5007.30(1)-4
2352-6467,1,1,1,8,0,4,12,,10.1016/j.ijpam.2017.03.002
2768-6655,1,1,1,3,29,0,32,,10.37349/ei.2021.00018
2768-6655,1,1,1,18,56,3,77,,10.37349/ei.2021.00016
1110-1849 1687-1804,1,1,1,0,28,0,28,,10.1016/j.egja.2016.07.004
2192-2195 2192-2209,1,1,1,0,13,7,20,,10.1007/s13659-018-0169-7
2192-2195 2192-2209,1,1,1,0,30,8,38,,10.1007/s13659-018-0167-9
2192-2195 2192-2209,1,1,1,0,28,0,28,,10.1007/s13659-019-00218-z
2410-3888,1,1,1,2,29,16,47,,10.3390/fishes4020035
2410-3888,1,1,1,0,35,1,36,,10.3390/fishes6010007
2195-3228 2251-7715,1,1,1,0,42,19,61,,10.1007/s40093-018-0231-9
0100-1965 1518-8353,1,1,1,1,0,17,18,,10.1590/S0100-19652004000300012
2314-7202 2314-7210,1,1,1,0,5,2,7,,10.1186/s43093-020-00044-7
2314-7202 2314-7210,1,1,1,77,3,13,93,,10.1186/s43093-020-00043-8
2314-7202 2314-7210,1,1,1,6,46,7,59,,10.1186/s43093-021-00059-8
2314-7202 2314-7210,1,1,1,16,0,29,45,,10.1016/j.fbj.2016.05.004
2452-3364,1,1,1,0,0,4,4,,10.1016/j.jons.2016.09.002
2520-8934,1,1,1,0,10,0,10,,10.1186/s42155-020-00184-5
2520-8934,1,1,1,0,10,0,10,,10.1186/s42155-021-00225-7
2520-8934,1,1,1,0,17,2,19,,10.1186/s42155-021-00271-1
2520-8934,1,1,1,0,9,0,9,,10.1186/s42155-021-00224-8
2520-8934,1,1,1,0,78,6,84,,10.1186/s42155-021-00270-2
2254-7088,1,1,1,28,0,16,44,,10.17979/ejge.2012.1.2.4280
2254-7088,1,1,1,9,0,0,9,,10.17979/ejge.2014.3.1.4298
2196-5404,1,1,1,45,0,1,46,,10.1186/s40580-021-00291-6
2196-5404,1,1,1,74,0,5,79,,10.1186/s40580-021-00290-7
2196-5404,1,1,1,3,208,13,224,,10.1186/s40580-017-0100-7
2196-5404,1,1,1,0,32,4,36,,10.1186/s40580-021-00260-z
2543-912X,1,1,1,32,0,27,59,,10.2478/emj-2021-0026
2543-912X,1,1,1,8,0,20,28,,10.2478/emj-2021-0019
2543-912X,1,1,1,15,0,1,16,,10.2478/emj-2021-0023
2449-8343,1,1,1,10,0,6,16,,10.2478/hepo-2021-0017
2449-8343,1,1,1,2,0,31,33,,10.2478/hepo-2021-0014
2393-1817,1,1,1,8,0,2,10,,10.2478/jccm-2021-0019
2450-8608,1,1,1,23,0,4,27,,10.2478/jvetres-2020-0012
2450-8608,1,1,1,19,0,10,29,,10.2478/jvetres-2020-0008
2353-8589,1,1,1,1,0,24,25,,10.2478/oszn-2021-0008
2066-7779,1,1,1,10,0,9,19,,10.2478/ausfm-2021-0012
2066-7779,1,1,1,32,0,15,47,,10.2478/ausfm-2021-0016
2335-0245,1,1,1,30,0,7,37,,10.2478/bjdm-2021-0021
2081-6936,1,1,1,44,0,0,44,,10.1515/tnsci-2016-0004
2081-6936,1,1,1,33,0,4,37,,10.1515/tnsci-2016-0013
2081-6936,1,1,1,143,0,8,151,,10.1515/tnsci-2016-0016
2081-6936,1,1,1,118,0,1,119,,10.1515/tnsci-2019-0035
2081-6936,1,1,1,31,0,1,32,,10.1515/tnsci-2019-0017
2081-6936,1,1,1,7,0,2,9,,10.1515/tnsci-2019-0023
2081-6936,1,1,1,56,0,0,56,,10.1515/tnsci-2019-0036
0514-6658 2560-4279,1,1,1,14,0,28,42,,10.5937/ZemBilj2002068L
2198-9788 2199-1154,1,1,1,1,14,4,19,,10.1007/s40801-019-00173-8
2198-9788 2199-1154,1,1,1,0,8,1,9,,10.1007/s40801-020-00195-7
2223-7690 2223-7704,1,1,1,0,31,6,37,,10.1007/s40544-019-0325-z
1198-2241 1916-7245,1,1,1,3,39,8,50,,10.1155/2021/1385322
2196-7091,1,1,1,6,10,15,31,,10.1186/s40561-021-00179-2
2415-7422 2415-7430,1,1,1,1,0,0,1,,10.32703/2415-7422-2020-10-2-281-292
2415-7422 2415-7430,1,1,1,2,13,13,28,,10.32703/2415-7422-2020-10-2-163-184
2602-3040,1,1,1,0,0,1,1,,10.17826/cumj.566275
2602-3040,1,1,1,13,0,6,19,,10.17826/cumj.459036
2602-3040,1,1,1,10,0,4,14,,10.17826/cumj.529414
2602-3040,1,1,1,26,0,2,28,,10.17826/cumj.560650
2602-3040,1,1,1,21,0,9,30,,10.17826/cumj.457925
2602-3040,1,1,1,2,0,1,3,,10.17826/cumj.557579
2602-3040,1,1,1,1,0,0,1,,10.17826/cumj.565685
2602-3040,1,1,1,12,3,4,19,,10.17826/cumj.484542
2602-3040,1,1,1,0,0,1,1,,10.17826/cumj.396952
2602-3040,1,1,1,0,0,1,1,,10.17826/cumj.327430
2602-3040,1,1,1,0,0,1,1,,10.17826/cumj.327703
2602-3040,1,1,1,0,0,1,1,,10.17826/cumj.397580
2602-3040,1,1,1,16,0,7,23,,10.17826/cumj.408139
2602-3040,1,1,1,0,0,1,1,,10.17826/cumj.340257
2055-2238,1,1,1,1,35,11,47,,10.1002/osp4.397
2055-2238,1,1,1,0,33,4,37,,10.1002/osp4.528
2055-2238,1,1,1,1,103,12,116,,10.1002/osp4.531
2055-2238,1,1,1,3,37,2,42,,10.1002/osp4.459
2226-5856 2589-0360,1,1,1,5,0,29,34,,10.1016/j.jum.2016.05.001
2729-7640,1,1,1,11,0,13,24,,10.2478/alfa-2021-0010
2729-7640,1,1,1,4,0,28,32,,10.2478/alfa-2021-0017
2093-9175 2233-8853,1,1,1,0,34,2,36,,10.17241/smr.2021.00948
2093-9175 2233-8853,1,1,1,0,28,9,37,,10.17241/smr.2021.00878
1960-6060,1,1,1,0,40,0,40,,10.4000/samaj.7365
1960-6060,1,1,1,0,3,0,3,,10.4000/samaj.7173
2411-8729 2409-4161,1,1,1,6,0,5,11,,10.19048/2411-8729-2020-6-2-44-48
2411-8729 2409-4161,1,1,1,9,0,10,19,,10.19048/2411-8729-2020-6-1-4-13
2411-8729 2409-4161,1,1,1,8,0,7,15,,10.19048/2411-8729-2020-6-2-31-34
2411-8729 2409-4161,1,1,1,0,0,3,3,,10.19048/2411-8729-2019-5-1-16-18
2411-8729 2409-4161,1,1,1,3,0,2,5,,10.19048/2411-8729-2019-5-1-25-28
2411-8729 2409-4161,1,1,1,1,0,10,11,,10.19048/2411-8729-2019-5-1-21-24
2633-4895,1,1,1,0,20,5,25,,10.1177/26334895211054363
2521-6392,1,1,1,0,3,0,3,,10.31521/modecon.V11(2018)-08
2504-5288,1,1,1,0,16,0,16,,10.1159/000514291
2673-3161,1,1,1,0,11,12,23,,10.3390/applmech2020013
2054-9369,1,1,1,0,1,0,1,,10.1186/s40779-021-00312-9
2054-9369,1,1,1,2,31,1,34,,10.1186/s40779-021-00359-8
2054-9369,1,1,1,51,0,49,100,,10.1186/s40779-021-00349-w
2524-8987,1,1,1,56,3,17,76,,10.1186/s13089-021-00248-0
2524-8987,1,1,1,0,23,1,24,,10.1186/s13089-021-00247-1
2524-8987,1,1,1,0,4,1,5,,10.1186/s13089-020-00200-8
2524-8987,1,1,1,1,22,2,25,,10.1186/s13089-021-00246-2
2524-8987,1,1,1,0,29,13,42,,10.1186/s13089-021-00220-y
0352-5252 1820-1202,1,1,1,6,0,7,13,,10.5937/asn2183136C
0352-5252 1820-1202,1,1,1,15,0,5,20,,10.5937/asn2183203O
0352-5252 1820-1202,1,1,1,35,0,3,38,,10.5937/asn2183213S
0350-2120 2683-4162,1,1,1,6,0,11,17,,10.5937/AnEkSub2145149P
0350-2120 2683-4162,1,1,1,23,0,14,37,,10.5937/AnEkSub2145041K
0350-2120 2683-4162,1,1,1,26,0,9,35,,10.5937/AnEkSub2145051P
2197-425X,1,1,1,0,20,2,22,,10.1186/s40635-021-00385-9
2197-425X,1,1,1,0,35,2,37,,10.1186/s40635-021-00379-7
2662-9984,1,1,1,4,68,77,149,,10.1007/s43621-021-00029-8
2662-9984,1,1,1,0,35,25,60,,10.1007/s43621-021-00062-7
2662-9984,1,1,1,0,40,35,75,,10.1007/s43621-021-00065-4
2663-4023,1,1,1,0,11,12,23,,10.28925/2663-4023.2021.11.155165
2541-044X 2541-2019,1,1,1,0,13,4,17,,10.33395/sinkron.v5i2.10713
2475-0263,1,1,1,0,31,8,39,,10.1080/24750263.2020.1717653
2475-0263,1,1,1,0,82,21,103,,10.1080/24750263.2020.1757168
2475-0263,1,1,1,1,15,23,39,,10.1080/24750263.2020.1818856
2475-0263,1,1,1,0,22,10,32,,10.1080/24750263.2020.1716866
2475-0263,1,1,1,1,78,14,93,,10.1080/24750263.2020.1810336
2475-0263,1,1,1,0,25,11,36,,10.1080/24750263.2020.1829110
0972-8600 2543-3474,1,1,1,0,13,9,22,,10.1016/j.akcej.2019.04.002
0972-8600 2543-3474,1,1,1,0,11,5,16,,10.1016/j.akcej.2019.05.003
0972-8600 2543-3474,1,1,1,0,10,2,12,,10.1016/j.akcej.2018.08.004
0972-8600 2543-3474,1,1,1,0,2,3,5,,10.1016/j.akcej.2018.08.007
0972-8600 2543-3474,1,1,1,0,7,9,16,,10.1016/j.akcej.2019.07.001
0972-8600 2543-3474,1,1,1,0,1,3,4,,10.1016/j.akcej.2019.08.002
0972-8600 2543-3474,1,1,1,0,1,7,8,,10.1016/j.akcej.2019.08.006
0972-8600 2543-3474,1,1,1,0,8,5,13,,10.1016/j.akcej.2018.09.003
0972-8600 2543-3474,1,1,1,0,3,3,6,,10.1016/j.akcej.2018.10.001
0972-8600 2543-3474,1,1,1,0,9,13,22,,10.1016/j.akcej.2018.11.001
0972-8600 2543-3474,1,1,1,0,12,4,16,,10.1016/j.akcej.2020.02.003
0972-8600 2543-3474,1,1,1,35,9,22,66,,10.1016/j.akcej.2017.05.002
0972-8600 2543-3474,1,1,1,0,4,11,15,,10.1016/j.akcej.2017.02.002
0972-8600 2543-3474,1,1,1,0,3,1,4,,10.1016/j.akcej.2018.01.018
0972-8600 2543-3474,1,1,1,0,5,7,12,,10.1016/j.akcej.2017.10.004
2673-4001,1,1,1,0,49,6,55,,10.3390/telecom1030019
0104-9070 2595-7686,1,1,1,22,0,9,31,,10.36812/pag.201925366-79
0104-9070 2595-7686,1,1,1,5,0,22,27,,10.36812/pag.201925351-65
1016-7315 2212-5043,1,1,1,20,0,2,22,,10.1016/j.jsha.2015.12.003
1016-7315 2212-5043,1,1,1,23,0,2,25,,10.1016/j.jsha.2017.01.008
1016-7315 2212-5043,1,1,1,13,0,3,16,,10.1016/j.jsha.2017.04.002
2096-5311 2632-1742,1,1,1,0,40,28,68,,10.1177/2096531120930956
2520-8454,1,1,1,0,7,3,10,,10.1186/s42047-020-00070-3
2520-8454,1,1,1,0,9,2,11,,10.1186/s42047-021-00100-8
2296-9365 2296-9403,1,1,1,0,1,54,55,,10.1159/000508160
2053-1095,1,1,1,0,4,10,14,,10.1002/vms3.259
2053-1095,1,1,1,0,18,15,33,,10.1002/vms3.377
2053-1095,1,1,1,0,4,10,14,,10.1002/vms3.385
2053-1095,1,1,1,4,11,2,17,,10.1002/vms3.366
0971-2119 0974-1844,1,1,1,0,42,15,57,,10.1080/09712119.2019.1575223
0971-2119 0974-1844,1,1,1,0,28,13,41,,10.1080/09712119.2019.1583570
0971-2119 0974-1844,1,1,1,0,37,3,40,,10.1080/09712119.2019.1624261
0971-2119 0974-1844,1,1,1,0,29,1,30,,10.1080/09712119.2019.1662424
0971-2119 0974-1844,1,1,1,0,45,4,49,,10.1080/09712119.2020.1732394
0971-2119 0974-1844,1,1,1,0,25,8,33,,10.1080/09712119.2020.1782218
0971-2119 0974-1844,1,1,1,1,35,15,51,,10.1080/09712119.2020.1825446
0971-2119 0974-1844,1,1,1,0,25,16,41,,10.1080/09712119.2020.1837137
0971-2119 0974-1844,1,1,1,1,22,15,38,,10.1080/09712119.2018.1512498
0971-2119 0974-1844,1,1,1,0,42,17,59,,10.1080/09712119.2017.1380029
0971-2119 0974-1844,1,1,1,1,6,24,31,,10.1080/09712119.2017.1416616
2569-7102 2569-7110,1,1,1,12,0,18,30,,10.5194/gc-3-179-2020
2569-7102 2569-7110,1,1,1,29,0,15,44,,10.5194/gc-3-233-2020
1213-8118 1804-7521,1,1,1,0,17,1,18,,10.5507/bp.2016.051
1213-8118 1804-7521,1,1,1,1,21,1,23,,10.5507/bp.2016.056
1213-8118 1804-7521,1,1,1,1,12,4,17,,10.5507/bp.2018.019
1213-8118 1804-7521,1,1,1,0,26,4,30,,10.5507/bp.2018.035
1213-8118 1804-7521,1,1,1,1,76,12,89,,10.5507/bp.2017.057
2410-387X,1,1,1,0,8,13,21,,10.3390/cryptography4030021
2041-6695,1,1,1,0,12,3,15,,10.1068/i0551sas
2041-6695,1,1,1,0,19,1,20,,10.1177/2041669516672219
2041-6695,1,1,1,0,32,0,32,,10.1177/2041669520961120
1998-9563 2224-7955,1,1,1,1,36,37,74,,10.2166/nh.2020.184
1998-9563 2224-7955,1,1,1,0,49,2,51,,10.2166/nh.2020.032
1998-9563 2224-7955,1,1,1,21,0,14,35,,10.2166/nh.2020.070
2192-5372,1,1,1,5,37,13,55,,10.1186/s13731-018-0087-2
2628-491X,1,1,1,32,0,14,46,,10.1515/almed-2020-0011
2628-491X,1,1,1,66,0,5,71,,10.1515/almed-2020-0087
2628-491X,1,1,1,9,0,0,9,,10.1515/almed-2020-0108
2628-491X,1,1,1,36,0,3,39,,10.1515/almed-2020-0118
2628-491X,1,1,1,4,0,2,6,,10.1515/almed-2021-0003
2628-491X,1,1,1,74,0,10,84,,10.1515/almed-2019-0027
2628-491X,1,1,1,7,0,3,10,,10.1515/almed-2019-0032
2628-491X,1,1,1,2,0,4,6,,10.1515/almed-2020-0032
2628-491X,1,1,1,8,0,10,18,,10.1515/almed-2020-0039
2628-491X,1,1,1,12,0,1,13,,10.1515/almed-2020-0042
2628-491X,1,1,1,76,0,10,86,,10.1515/almed-2019-0012
2628-491X,1,1,1,9,0,0,9,,10.1515/almed-2019-0039
2628-491X,1,1,1,12,0,28,40,,10.1515/almed-2020-0008
2628-491X,1,1,1,18,0,6,24,,10.1515/almed-2020-0017
2509-9280,1,1,1,0,23,1,24,,10.1186/s41747-019-0116-3
2509-9280,1,1,1,0,41,0,41,,10.1186/s41747-020-00183-0
2509-9280,1,1,1,1,31,0,32,,10.1186/s41747-019-0122-5
2473-2877,1,1,1,1,47,1,49,,10.1063/5.0039366
2256-0939,1,1,1,7,0,25,32,,10.2478/plua-2021-0007
2256-0939,1,1,1,11,0,12,23,,10.2478/plua-2021-0008
2256-0939,1,1,1,16,0,6,22,,10.2478/plua-2021-0010
1819-7973 1997-2067,1,1,1,6,7,8,21,,10.46903/gjms/16.04.1958
2333-3928,1,1,1,0,31,4,35,,10.1177/2333392815589094
1257-5011 1989-8886,1,1,1,1,9,20,30,,10.4995/wrs.2020.12779
1257-5011 1989-8886,1,1,1,1,18,10,29,,10.4995/wrs.2015.3594
1257-5011 1989-8886,1,1,1,0,46,9,55,,10.4995/wrs.2020.12273
2308-6122,1,1,1,0,21,0,21,,10.4000/cy.6286
0338-9316 2261-0200,1,1,1,0,3,0,3,,10.4000/yod.4553
1168-1446 2275-2145,1,1,1,0,2,0,2,,10.4000/sds.11323
2038-3215,1,1,1,0,5,0,5,,10.4000/aam.3994
1305-2489 2687-1955,1,1,1,1,23,2,26,,10.33719/yud.2021;16-2-834672
2688-268X 2688-3988,1,1,1,13,148,26,187,,10.1002/VIW.20200034
1794-161X 2389-7864,1,1,1,0,1,14,15,,10.21676/23897864.2696
1794-161X 2389-7864,1,1,1,0,14,5,19,,10.21676/23897864.3150
1794-161X 2389-7864,1,1,1,0,0,1,1,,10.21676/23897864.2628
2193-6382 2193-8229,1,1,1,38,0,29,67,,10.1007/s40121-019-00262-9
2508-7940 2508-7959,1,1,1,0,63,8,71,,10.23838/pfm.2020.00191
2508-7940 2508-7959,1,1,1,0,0,30,30,,10.23838/pfm.2019.00079
2222-1867 2222-1875,1,1,1,1,11,11,23,,10.21511/pmf.10(1).2021.01
2624-6120,1,1,1,0,22,9,31,,10.3390/signals2020015
2730-7182,1,1,1,67,1,10,78,,10.1186/s12862-021-01939-x
0016-6987 2035-5556,1,1,1,2,14,16,32,,10.1186/s41118-021-00146-2
2328-8604 2328-8620,1,1,1,0,37,17,54,,10.1080/23288604.2017.1340927
2328-8604 2328-8620,1,1,1,0,7,4,11,,10.1080/23288604.2020.1840824
2328-8604 2328-8620,1,1,1,2,17,17,36,,10.1080/23288604.2017.1315477
2328-8604 2328-8620,1,1,1,0,29,9,38,,10.1080/23288604.2019.1596050
2328-8604 2328-8620,1,1,1,3,39,13,55,,10.1080/23288604.2018.1541497
2658-381X,1,1,1,2,23,10,35,,10.3897/rrpharmacology.7.66627
2658-381X,1,1,1,0,19,2,21,,10.3897/rrpharmacology.7.77709
1314-2615 1768-1448,1,1,1,0,18,8,26,,10.3897/subtbiol.40.76301
2055-7434,1,1,1,28,0,8,36,,10.1038/s41378-021-00327-1
2055-7434,1,1,1,5,32,9,46,,10.1038/s41378-021-00252-3
2390-0725 2422-3182,1,1,1,16,0,29,45,,10.22430/24223182.1609
2730-5422,1,1,1,0,16,6,22,,10.1186/s13663-021-00707-2
0547-3330 2560-3051,1,1,1,0,0,25,25,,10.5937/nasvas2102217V
1750-0680,1,1,1,1,11,19,31,,10.1186/s13021-016-0047-8
2236-3785,1,1,1,0,93,7,100,,10.21876/rcshci.v10i4.960
1729-0376 1813-4424,1,1,1,0,29,7,36,,10.1080/17290376.2016.1229213
2585-6839 2585-6847,1,1,1,7,0,3,10,,10.21303/2585-6847.2020.001537
2052-7276,1,1,1,3,62,8,73,,10.1038/s41438-018-0016-3
2052-7276,1,1,1,1,70,8,79,,10.1038/s41438-018-0056-8
2052-7276,1,1,1,1,49,2,52,,10.1038/s41438-019-0153-3
2052-7276,1,1,1,44,0,7,51,,10.1038/s41438-017-0002-1
2052-7276,1,1,1,2,47,1,50,,10.1038/s41438-018-0030-5
2052-7276,1,1,1,0,78,7,85,,10.1038/s41438-019-0172-0
2052-7276,1,1,1,8,47,8,63,,10.1038/s41438-018-0065-7
1286-4986,1,1,1,0,5,0,5,,10.4000/alsic.544
1286-4986,1,1,1,0,14,0,14,,10.4000/alsic.2267
1110-5690 2090-3251,1,1,1,22,0,6,28,,10.1016/j.mefs.2013.05.008
1110-5690 2090-3251,1,1,1,13,0,6,19,,10.1016/j.mefs.2017.07.008
1110-5690 2090-3251,1,1,1,0,5,12,17,,10.1186/s43043-021-00053-8
1475-6366 1475-6374,1,1,1,0,31,7,38,,10.1080/14756366.2019.1576657
1475-6366 1475-6374,1,1,1,1,25,7,33,,10.1080/14756366.2019.1612887
1475-6366 1475-6374,1,1,1,0,31,3,34,,10.1080/14756366.2018.1532419
1933-6918 1933-6926,1,1,1,0,33,8,41,,10.1080/19336918.2019.1639303
1933-6918 1933-6926,1,1,1,0,0,1,1,,10.1080/19336918.2021.1996749
1933-6918 1933-6926,1,1,1,0,25,0,25,,10.1080/19336918.2021.1921402
1933-6918 1933-6926,1,1,1,4,69,7,80,,10.1080/19336918.2021.1935407
2083-2931 2084-574X,1,1,1,12,0,13,25,,10.18778/2083-2931.11.15
2083-2931 2084-574X,1,1,1,6,0,15,21,,10.18778/2083-2931.11.14
2083-2931 2084-574X,1,1,1,13,0,11,24,,10.18778/2083-2931.11.06
2331-1983,1,1,1,0,12,18,30,,10.1080/23311983.2015.1071689
2698-4016,1,1,1,79,0,5,84,,10.5194/wcd-2-1131-2021
0103-1813 2175-764X,1,1,1,3,0,25,28,,10.1590/S0103-18132008000200008
1529-1227,1,1,1,25,0,45,70,,10.21307/joss-2019-034
2713-4148,1,1,1,0,7,3,10,,10.3345/cep.2020.01228
2713-4148,1,1,1,0,34,2,36,,10.3345/kjp.2019.00815
2713-4148,1,1,1,0,8,2,10,,10.3345/cep.2021.00605
2713-4148,1,1,1,0,22,11,33,,10.3345/cep.2021.00507
2713-4148,1,1,1,0,68,28,96,,10.3345/cep.2020.01676
2713-4148,1,1,1,0,31,2,33,,10.3345/cep.2019.01466
2713-4148,1,1,1,0,45,6,51,,10.3345/cep.2020.00052
2713-4148,1,1,1,0,18,5,23,,10.3345/cep.2020.00143
2713-4148,1,1,1,0,23,12,35,,10.3345/cep.2020.01438
2448-167X,1,1,1,12,0,4,16,,10.1590/0370-44672018720162
2146-0744,1,1,1,36,0,7,43,,10.34111/ijebeg.20191122
2666-9366,1,1,1,0,21,0,21,,10.21468/SciPostPhysCore.4.4.032
1600-0889,1,1,1,5,38,16,59,,10.1080/16000889.2020.1721224
1600-0889,1,1,1,1,23,1,25,,10.3402/tellusb.v65i0.19922
1128-7462 1591-7398,1,1,1,2,30,10,42,,10.1080/11287462.2018.1527672
1128-7462 1591-7398,1,1,1,0,34,5,39,,10.1080/11287462.2020.1717896
1351-0002 1743-2928,1,1,1,0,25,2,27,,10.1080/13510002.2020.1826750
0997-1327 2105-2271,1,1,1,0,1,0,1,,10.4000/remmm.6299
0997-1327 2105-2271,1,1,1,0,1,0,1,,10.4000/remmm.6333
0997-1327 2105-2271,1,1,1,0,2,0,2,,10.4000/remmm.9247
0997-1327 2105-2271,1,1,1,0,7,0,7,,10.4000/remmm.11699
0997-1327 2105-2271,1,1,1,0,4,0,4,,10.4000/remmm.3251
0997-1327 2105-2271,1,1,1,0,3,0,3,,10.4000/remmm.7578
0997-1327 2105-2271,1,1,1,0,5,0,5,,10.4000/remmm.14536
0997-1327 2105-2271,1,1,1,0,16,0,16,,10.4000/remmm.13038
0997-1327 2105-2271,1,1,1,0,2,0,2,,10.4000/remmm.2822
0997-1327 2105-2271,1,1,1,0,6,0,6,,10.4000/remmm.12169
0997-1327 2105-2271,1,1,1,0,2,0,2,,10.4000/remmm.46
0997-1327 2105-2271,1,1,1,0,9,0,9,,10.4000/remmm.11649
0997-1327 2105-2271,1,1,1,0,3,0,3,,10.4000/remmm.8548
0997-1327 2105-2271,1,1,1,0,1,0,1,,10.4000/remmm.9399
0997-1327 2105-2271,1,1,1,0,2,0,2,,10.4000/remmm.8447
0997-1327 2105-2271,1,1,1,0,3,0,3,,10.4000/remmm.9534
0997-1327 2105-2271,1,1,1,0,1,0,1,,10.4000/remmm.7954
0997-1327 2105-2271,1,1,1,0,3,0,3,,10.4000/remmm.10277
0997-1327 2105-2271,1,1,1,0,11,0,11,,10.4000/remmm.9077
0997-1327 2105-2271,1,1,1,0,2,0,2,,10.4000/remmm.304
0997-1327 2105-2271,1,1,1,0,2,0,2,,10.4000/remmm.6704
0997-1327 2105-2271,1,1,1,0,41,0,41,,10.4000/remmm.15109
2161-4083,1,1,1,0,6,3,9,,10.1080/21614083.2020.1834761
2164-2583,1,1,1,0,20,2,22,,10.1080/21642583.2019.1707725
2164-2583,1,1,1,0,38,1,39,,10.1080/21642583.2020.1734985
2164-2583,1,1,1,0,29,17,46,,10.1080/21642583.2021.2010618
2001-6689,1,1,1,0,19,28,47,,10.1080/20016689.2019.1705120
2001-6689,1,1,1,0,9,5,14,,10.1080/20016689.2020.1738637
2001-6689,1,1,1,0,46,13,59,,10.1080/20016689.2020.1775933
1745-8080 1745-8099,1,1,1,0,46,0,46,,10.1080/17458080.2020.1796977
1745-8080 1745-8099,1,1,1,0,31,1,32,,10.1080/17458080.2020.1796979
2057-178X,1,1,1,0,28,10,38,,10.1177/2057178X18791034
2057-178X,1,1,1,0,16,2,18,,10.1177/2057178X19858453
2471-5492,1,1,1,0,30,0,30,,10.1177/2471549217750465
2471-5492,1,1,1,22,0,1,23,,10.1177/2471549217695260
1231-1952 1896-1525,1,1,1,7,0,18,25,,10.1515/esrp-2015-0013
1468-6996 1878-5514,1,1,1,0,40,1,41,,10.1080/14686996.2019.1619479
1468-6996 1878-5514,1,1,1,0,63,2,65,,10.1080/14686996.2019.1694841
1468-6996 1878-5514,1,1,1,0,51,9,60,,10.1080/14686996.2019.1697617
1674-2818 2049-3169,1,1,1,41,1,2,44,,10.1038/s41368-021-00142-4
1687-8426 2314-8551,1,1,1,0,15,2,17,,10.1186/s43168-020-00023-0
1687-8426 2314-8551,1,1,1,41,0,6,47,,10.4103/1687-8426.203803
1687-8426 2314-8551,1,1,1,1,17,6,24,,10.4103/ejb.ejb_88_17
1687-8426 2314-8551,1,1,1,2,27,2,31,,10.4103/1687-8426.193647
1687-8426 2314-8551,1,1,1,0,15,9,24,,10.4103/1687-8426.176663
1687-8426 2314-8551,1,1,1,1,31,4,36,,10.4103/1687-8426.184373
1687-8426 2314-8551,1,1,1,34,0,23,57,,10.4103/1687-8426.193641
1687-8426 2314-8551,1,1,1,37,0,4,41,,10.4103/1687-8426.176658
2564-6583 2602-229X,1,1,1,0,0,4,4,,10.30913/alinterisosbil.349172
2191-9089 2191-9097,1,1,1,45,0,0,45,,10.1515/ntrev-2021-0059
2191-9089 2191-9097,1,1,1,40,0,1,41,,10.1515/ntrev-2021-0063
2191-9089 2191-9097,1,1,1,38,0,2,40,,10.1515/ntrev-2021-0081
2191-9089 2191-9097,1,1,1,25,0,0,25,,10.1515/ntrev-2021-0105
2191-9089 2191-9097,1,1,1,60,0,0,60,,10.1515/ntrev-2021-0016
2191-9089 2191-9097,1,1,1,60,0,8,68,,10.1515/ntrev-2021-0098
2191-9089 2191-9097,1,1,1,39,0,11,50,,10.1515/ntrev-2021-0107
2191-9089 2191-9097,1,1,1,123,0,27,150,,10.1515/ntrev-2021-0112
2191-9089 2191-9097,1,1,1,53,0,7,60,,10.1515/ntrev-2021-0117
2191-9089 2191-9097,1,1,1,40,0,8,48,,10.1515/ntrev-2021-0022
2191-9089 2191-9097,1,1,1,56,0,4,60,,10.1515/ntrev-2021-0033
2191-9089 2191-9097,1,1,1,47,0,5,52,,10.1515/ntrev-2021-0050
2191-9089 2191-9097,1,1,1,47,0,6,53,,10.1515/ntrev-2021-0064
2191-9089 2191-9097,1,1,1,131,0,41,172,,10.1515/ntrev-2021-0065
2096-5044 2523-3254,1,1,1,0,44,5,49,,10.1186/s42397-021-00106-3
2367-8194,1,1,1,0,27,3,30,,10.3897/oneeco.6.e73269
2364-9534,1,1,1,1,7,10,18,,10.1186/s41120-019-0033-9
2510-3636,1,1,1,41,3,5,49,,10.1186/s41824-020-00085-9
2235-6282,1,1,1,1,16,18,35,,10.1186/s41937-021-00077-x
0121-4500 2346-0261,1,1,1,0,0,10,10,,10.15446/av.enferm.v32n1.46032
0121-4500 2346-0261,1,1,1,0,4,0,4,,10.15446/av.enferm.v33n2.52931
0121-4500 2346-0261,1,1,1,0,14,7,21,,10.15446/av.enferm.v34n1.44488
2631-4940,1,1,1,5,2,2,9,,10.1136/bmjsit-2021-000102
1176-9343,1,1,1,0,30,2,32,,10.1177/1176934319879920
2673-818X,1,1,1,2,152,11,165,,10.3389/fviro.2021.782886
2399-2026,1,1,1,2,43,10,55,,10.1177/23992026211062729
2096-5672 2577-3585,1,1,1,16,0,3,19,,10.1097/JBR.0000000000000036
1751-8628 1751-8636,1,1,1,2,28,2,32,,10.1049/cmu2.12167
1694-7886 1694-7894,1,1,1,7,0,3,10,,10.24969/hvt.2020.236
2377-9489 2377-9497,1,1,1,0,8,37,45,,10.1080/23779497.2021.1929387
2470-2897 2470-2900,1,1,1,0,10,2,12,,10.1177/2470289719882438
1406-099X 2334-4385,1,1,1,1,41,7,49,,10.1080/1406099X.2021.1990473
1406-099X 2334-4385,1,1,1,0,36,4,40,,10.1080/1406099X.2017.1309785
2237-9363 2317-6423,1,1,1,24,0,8,32,,10.1055/s-0041-1741323
2237-9363 2317-6423,1,1,1,7,0,12,19,,10.1055/s-0041-1730389
2046-6390,1,1,1,0,47,2,49,,10.1242/bio.058736
2046-6390,1,1,1,0,1,0,1,,10.1242/bio.058979
2046-6390,1,1,1,3,55,12,70,,10.1242/bio.055475
2198-9761,1,1,1,14,86,28,128,,10.1186/s40798-018-0137-0
2197-8670,1,1,1,0,51,18,69,,10.1186/s40677-017-0089-6
1369-6513 1369-7625,1,1,1,0,30,10,40,,10.1111/hex.13346
2427-920X,1,1,1,0,2,0,2,,10.4000/itineraires.2725
2075-082X 2542-2189,1,1,1,0,7,0,7,,10.26442/2075082X.2020.4.200528
2075-082X 2542-2189,1,1,1,0,6,0,6,,10.26442/2075082X.2020.4.200546
2075-082X 2542-2189,1,1,1,0,15,0,15,,10.26442/2075082X.2020.2.200221
2075-082X 2542-2189,1,1,1,0,3,0,3,,10.26442/2075082X.2020.3.200414
0957-4530 1573-4838,1,1,1,0,45,1,46,,10.1007/s10856-021-06620-9
0957-4530 1573-4838,1,1,1,0,33,3,36,,10.1007/s10856-021-06607-6
1952-8108 2109-9405,1,1,1,0,11,0,11,,10.4000/anneemaghreb.8139
2271-5703,1,1,1,0,1,0,1,,10.4000/lengas.1305
2271-5703,1,1,1,0,1,0,1,,10.4000/lengas.1196
2271-5703,1,1,1,0,3,0,3,,10.4000/lengas.2886
2640-3501,1,1,1,0,16,8,24,,10.3934/mine.2021015
2640-3501,1,1,1,0,8,16,24,,10.3934/mine.2021001
2057-0082,1,1,1,7,39,9,55,,10.1186/s40945-021-00103-4
2396-832X,1,1,1,0,22,1,23,,10.1186/s41231-021-00087-0
2522-5774,1,1,1,0,20,19,39,,10.1186/s42252-021-00023-3
1759-3131 1759-314X,1,1,1,6,0,7,13,,10.1260/1759-3131.1.3-4.223
1865-1542,1,1,1,31,0,10,41,,10.3097/LO.200915
1865-1542,1,1,1,28,0,4,32,,10.3097/LO.200913
0270-5060 2156-6941,1,1,1,2,26,7,35,,10.1080/02705060.2017.1320307
0270-5060 2156-6941,1,1,1,3,36,4,43,,10.1080/02705060.2016.1248506
0270-5060 2156-6941,1,1,1,0,46,5,51,,10.1080/02705060.2018.1459324
2384-0293,1,1,1,0,23,4,27,,10.12701/yujm.2018.35.1.70
2384-0293,1,1,1,0,15,3,18,,10.12701/yujm.2018.35.2.213
2707-725X 2707-7268,1,1,1,0,5,26,31,,10.15407/zoo2021.01.041
2707-725X 2707-7268,1,1,1,0,94,31,125,,10.15407/zoo2021.01.025
1695-2618,1,1,1,0,10,19,29,,10.4995/eurocall.2020.12758
1806-1117 1806-9126,1,1,1,0,0,32,32,,10.1590/1806-9126-rbef-2017-0401
1806-1117 1806-9126,1,1,1,0,0,13,13,,10.1590/1806-9126-rbef-2016-0121
1806-1117 1806-9126,1,1,1,18,0,9,27,,10.1590/S1806-11172013000400010
1806-1117 1806-9126,1,1,1,0,0,22,22,,10.1590/1806-9126-rbef-2017-0326
1806-1117 1806-9126,1,1,1,0,0,25,25,,10.1590/1806-9126-rbef-2018-0105
1806-1117 1806-9126,1,1,1,0,0,17,17,,10.1590/1806-9126-rbef-2019-0001
1806-1117 1806-9126,1,1,1,0,0,25,25,,10.1590/1806-9126-rbef-2017-0151
1806-1117 1806-9126,1,1,1,1,0,6,7,,10.1590/S1806-11172013000300001
1810-8997 2313-1497,1,1,1,12,0,7,19,,10.14531/ss2021.3.94-99
2046-3758,1,1,1,3,22,0,25,,10.1302/2046-3758.1011.BJR-2021-0028.R1
2046-3758,1,1,1,0,50,5,55,,10.1302/2046-3758.102.BJR-2020-0171.R1
2673-6217,1,1,1,10,121,1,132,,10.3389/fragi.2021.714926
2300-4975,1,1,1,0,0,34,34,,10.1515/ssa-2015-0022
2217-8139 2335-0229,1,1,1,1,0,7,8,,10.5937/GRMK2103207M
2334-6477,1,1,1,6,0,4,10,,10.5937/halo27-32353
2335-4127 2385-8907,1,1,1,1,0,11,12,,10.34291/Edinost/76/02/Kriznar
2335-4127 2385-8907,1,1,1,2,0,23,25,,10.34291/Edinost/75/02/Petschnigg
2335-4127 2385-8907,1,1,1,0,1,16,17,,10.34291/Edinost/75/02/Debevec
2335-4127 2385-8907,1,1,1,1,0,8,9,,10.34291/Edinost/76/02/Tedesko
2335-4127 2385-8907,1,1,1,0,2,17,19,,10.34291/Edinost/75/Debevec
2335-4127 2385-8907,1,1,1,2,0,34,36,,10.34291/Edinost/75/Ivic
2335-4127 2385-8907,1,1,1,25,13,48,86,,10.34291/Edinost/76/02/Dragnea
0973-7510 2581-690X,1,1,1,0,17,0,17,,10.22207/JPAM.15.4.15
0973-7510 2581-690X,1,1,1,0,55,11,66,,10.22207/JPAM.15.4.13
0973-7510 2581-690X,1,1,1,0,24,9,33,,10.22207/JPAM.15.4.19
0973-7510 2581-690X,1,1,1,1,29,9,39,,10.22207/JPAM.15.4.30
0973-7510 2581-690X,1,1,1,0,21,3,24,,10.22207/JPAM.15.4.40
2242-458X,1,1,1,0,11,9,20,,10.3384/njvet.2242-458X.166114
0122-8706,1,1,1,17,0,18,35,,10.21930/rcta.vol22_num3_art:2290
2378-2242,1,1,1,1,40,1,42,,10.1002/lol2.10026
2378-2242,1,1,1,1,158,5,164,,10.1002/lol2.10044
2378-2242,1,1,1,1,65,9,75,,10.1002/lol2.10040
2378-2242,1,1,1,0,29,5,34,,10.1002/lol2.10052
2378-2242,1,1,1,0,38,1,39,,10.1002/lol2.10053
2378-2242,1,1,1,0,42,3,45,,10.1002/lol2.10051
2378-2242,1,1,1,1,192,7,200,,10.1002/lol2.10030
2378-2242,1,1,1,1,31,1,33,,10.1002/lol2.10049
2662-1363 2662-9291,1,1,1,0,35,0,35,,10.1186/s43020-021-00058-8
2196-4092,1,1,1,1,38,1,40,,10.1186/s40562-019-0131-5
2196-4092,1,1,1,3,24,10,37,,10.1186/s40562-021-00182-y
0020-5346 1613-964X,1,1,1,7,2,17,26,,10.1007/s10272-021-1014-5
0020-5346 1613-964X,1,1,1,1,2,20,23,,10.1007/s10272-021-1011-8
2662-2203,1,1,1,0,15,2,17,,10.1186/s43057-021-00061-4
2042-9738 2042-9746,1,1,1,3,44,89,136,,10.1049/els2.12026
2042-9738 2042-9746,1,1,1,0,15,8,23,,10.1049/els2.12030
2509-8012,1,1,1,1,24,2,27,,10.1186/s41313-020-00024-y
2367-0983 2367-2617,1,1,1,0,25,1,26,,10.1186/s41601-021-00188-w
1752-4458,1,1,1,0,51,29,80,,10.1186/s13033-019-0270-2
2414-3812 2519-2752,1,1,1,5,0,1,6,,10.31636/pmjua.v5i1.7
1759-720X 1759-7218,1,1,1,28,30,7,65,,10.1177/1759720X211059614
1751-956X 1751-9578,1,1,1,0,21,22,43,,10.1049/itr2.12125
2399-7117,1,1,1,7,0,65,72,,10.5334/wwwj.42
2008-4935 2008-6970,1,1,1,0,45,10,55,,10.1007/s40071-018-0208-3
2676-184X 2710-8856,1,1,1,0,0,12,12,,10.48100/merj.v2i2Special.105
2676-184X 2710-8856,1,1,1,34,0,48,82,,10.48100/merj.v2i2Special.102
2676-184X 2710-8856,1,1,1,13,0,1,14,,10.48100/merj.2020.145
2676-184X 2710-8856,1,1,1,0,0,13,13,,10.48100/merj.v2i3.112
2676-184X 2710-8856,1,1,1,9,0,20,29,,10.48100/merj.v2i3.111
2676-184X 2710-8856,1,1,1,2,0,15,17,,10.48100/merj.v2i2Special.101
2676-184X 2710-8856,1,1,1,1,0,13,14,,10.48100/merj.v2i2Special.98
2676-184X 2710-8856,1,1,1,2,0,24,26,,10.48100/merj.v1i2.32
2049-9361 2049-937X,1,1,1,0,7,2,9,,10.1177/20499361211021689
2693-1257,1,1,1,0,176,5,181,,10.34133/2021/9798714
2693-1257,1,1,1,0,38,5,43,,10.34133/2021/9890319
2184-6006,1,1,1,0,0,6,6,,10.5334/as.4
2051-3895 2051-3909,1,1,1,0,9,1,10,,10.1002/jmrs.553
2051-3895 2051-3909,1,1,1,0,9,8,17,,10.1002/jmrs.519
2051-3895 2051-3909,1,1,1,0,17,5,22,,10.1002/jmrs.517
2051-3895 2051-3909,1,1,1,0,16,6,22,,10.1002/jmrs.542
2594-1925,1,1,1,19,0,1,20,,10.37636/recit.v211419
1750-0443,1,1,1,1,77,13,91,,10.1049/mna2.12096
0020-2940 2051-8730,1,1,1,0,12,8,20,,10.1177/002029401204500605
0020-2940 2051-8730,1,1,1,0,25,17,42,,10.1177/0020294020925841
1176-9351,1,1,1,0,6,0,6,,10.1177/117693510500100105
2571-550X,1,1,1,0,35,74,109,,10.3390/quat4020012
2571-550X,1,1,1,2,71,55,128,,10.3390/quat4010009
1939-4551,1,1,1,34,0,10,44,,10.1186/s40413-018-0204-5
2520-8942,1,1,1,3,20,23,46,,10.1186/s42162-018-0028-0
2520-8942,1,1,1,1,29,8,38,,10.1186/s42162-018-0027-1
2520-8942,1,1,1,0,7,16,23,,10.1186/s42162-018-0041-3
2595-7007,1,1,1,1,10,10,21,,10.30886/estima.v18.947_PT
0100-5502 1981-5271,1,1,1,36,0,19,55,,10.1590/1981-52712015v43n1rb20180112
0265-6736 1464-5157,1,1,1,0,36,5,41,,10.1080/02656736.2019.1629650
0265-6736 1464-5157,1,1,1,0,36,1,37,,10.1080/02656736.2019.1675912
2310-2195 2310-2152,1,1,1,4,23,48,75,,10.4102/apsdpr.v9i1.562
2310-2195 2310-2152,1,1,1,1,27,45,73,,10.4102/apsdpr.v9i1.565
2352-3204,1,1,1,19,0,3,22,,10.1016/j.reth.2016.01.006
2352-5789,1,1,1,14,0,1,15,,10.1016/j.gore.2016.05.014
1229-1498 2384-4361,1,1,1,0,12,9,21,,10.18787/jr.2020.00334
1229-1498 2384-4361,1,1,1,0,10,12,22,,10.18787/jr.2021.00357
1229-1498 2384-4361,1,1,1,0,10,4,14,,10.18787/jr.2021.00354
1229-1498 2384-4361,1,1,1,0,13,2,15,,10.18787/jr.2021.00351
1229-1498 2384-4361,1,1,1,0,65,18,83,,10.18787/jr.2020.00321
2411-5150,1,1,1,0,32,3,35,,10.3390/vision1020016
0034-7434 2463-0225,1,1,1,5,0,12,17,,10.18597/rcog.1678
2673-1592,1,1,1,0,22,4,26,,10.3390/prosthesis3020017
1949-1034 1949-1042,1,1,1,3,257,12,272,,10.1080/19491034.2021.1962610
2055-4877,1,1,1,13,45,42,100,,10.1002/dep2.126
1818-331X 2074-0565,1,1,1,0,1,3,4,,https://doi.org/10.15407/jnpae2020.04.308
0303-7657 2317-6369,1,1,1,11,0,11,22,,10.1590/0303-7657000078613
0303-7657 2317-6369,1,1,1,13,0,18,31,,10.1590/0303-7657000064812
2673-4060,1,1,1,0,96,63,159,,10.3390/world2020020
2093-9043 2233-6273,1,1,1,8,0,3,11,,10.5469/neuroint.2012.7.2.85
2093-9043 2233-6273,1,1,1,6,0,1,7,,10.5469/neuroint.2013.8.2.101
2093-9043 2233-6273,1,1,1,7,0,0,7,,10.5469/neuroint.2016.11.2.131
0185-1063,1,1,1,25,0,12,37,,10.1016/j.hgmx.2015.04.002
2212-9774,1,1,1,10,0,6,16,,10.1016/j.wep.2016.11.003
2624-960X,1,1,1,0,8,3,11,,10.3390/quantum3020015
0121-4772 2248-4337,1,1,1,0,13,2,15,,10.15446/cuad.econ.v33n62.43670
2661-5150 2661-5290,1,1,1,1,0,1,2,,10.30525/2661-5150/2020-4-13
2661-5150 2661-5290,1,1,1,0,0,14,14,,10.30525/2661-5150/2020-4-24
2314-5749 2356-6981,1,1,1,1,9,0,10,,10.1155/2019/9418971
1661-4941,1,1,1,0,6,0,6,,10.4000/articulo.3483
1661-4941,1,1,1,0,7,0,7,,10.4000/articulo.1705
1661-4941,1,1,1,0,3,0,3,,10.4000/articulo.1381
1661-4941,1,1,1,0,27,0,27,,10.4000/articulo.2784
1661-4941,1,1,1,0,6,0,6,,10.4000/articulo.3261
1661-4941,1,1,1,0,41,0,41,,10.4000/articulo.2974
1661-4941,1,1,1,0,4,0,4,,10.4000/articulo.2088
1661-4941,1,1,1,0,4,0,4,,10.4000/articulo.3283
1661-4941,1,1,1,0,9,0,9,,10.4000/articulo.4446
1661-4941,1,1,1,0,8,0,8,,10.4000/articulo.3154
1661-4941,1,1,1,0,9,0,9,,10.4000/articulo.1153
1661-4941,1,1,1,0,10,0,10,,10.4000/articulo.2685
1661-4941,1,1,1,0,7,0,7,,10.4000/articulo.2708
1661-4941,1,1,1,0,7,0,7,,10.4000/articulo.417
1661-4941,1,1,1,0,1,0,1,,10.4000/articulo.915
1661-4941,1,1,1,0,5,0,5,,10.4000/articulo.1440
1661-4941,1,1,1,0,25,0,25,,10.4000/articulo.3670
2477-1392,1,1,1,0,5,16,21,,10.24233/BIOV.2.2.2016.35
2059-7002,1,1,1,1,20,2,23,,10.1177/2059700221993322
2084-879X,1,1,1,26,0,31,57,,10.1515/noise-2020-0004
1225-0767 2287-6715,1,1,1,0,10,6,16,,10.26748/KSOE.2020.069
2214-7535,1,1,1,8,0,1,9,,10.1016/j.bdq.2014.06.001
2504-3129,1,1,1,1,85,9,95,,10.3390/nitrogen2010005
2090-0422 2090-0430,1,1,1,5,31,3,39,,10.1155/2012/346501
2635-0254,1,1,1,0,17,0,17,,10.1177/26350254211044513
2369-7393 2369-7407,1,1,1,0,1,0,1,,10.5267/j.ac.2018.3.001
2369-7393 2369-7407,1,1,1,0,1,0,1,,10.5267/j.ac.2018.2.001
2164-9561 2164-957X,1,1,1,0,24,3,27,,10.1177/21649561211047804
2516-8657,1,1,1,0,48,3,51,,10.1177/25168657211063618
2516-8657,1,1,1,0,84,5,89,,10.1177/2516865720964808
2673-6357,1,1,1,0,15,1,16,,10.3390/hemato2020024
2692-3106,1,1,1,6,38,2,46,,10.37349/emed.2020.00028
2692-3106,1,1,1,26,127,3,156,,10.37349/emed.2021.00031
2573-8348,1,1,1,0,17,8,25,,10.1002/cnr2.1331
2573-8348,1,1,1,0,17,3,20,,10.1002/cnr2.1345
2573-8348,1,1,1,0,30,3,33,,10.1002/cnr2.1346
2639-6181,1,1,1,0,37,6,43,,10.1002/leg3.27
2617-409X,1,1,1,2,8,2,12,,https://doi.org/10.26565/2617-409X-2021-7-03
2576-2508 2576-2516,1,1,1,0,0,26,26,,10.37015/AUDT.2018.180804
2576-2508 2576-2516,1,1,1,0,0,35,35,,10.37015/AUDT.2018.180807
2576-2508 2576-2516,1,1,1,24,0,0,24,,10.37015/AUDT.2019.190814
2444-8451 2444-8494,1,1,1,5,0,6,11,,10.1108/EJMBE-03-2018-066
2168-1376,1,1,1,1,22,2,25,,10.1080/21681376.2018.1479982
1696-019X 2386-3978,1,1,1,3,10,19,32,,10.31921/doxacom.n30a2
1696-019X 2386-3978,1,1,1,1,15,9,25,,https://doi.org/10.31921/doxacom.n28a10
1696-019X 2386-3978,1,1,1,0,3,16,19,,10.31921/doxacom.n27a8
2194-7899,1,1,1,0,25,24,49,,10.1186/s40352-021-00158-2
2397-7523,1,1,1,54,2,3,59,,10.1186/s41512-020-00085-0
2233-7679,1,1,1,0,10,10,20,,10.17135/jdhs.2020.20.3.146
2233-7679,1,1,1,0,13,5,18,,10.17135/jdhs.2021.21.2.119
2662-2211,1,1,1,1,20,10,31,,10.1186/s43058-021-00240-8
2524-4655,1,1,1,1,15,7,23,,10.1186/s42522-021-00053-8
0144-5987 2048-4054,1,1,1,0,30,5,35,,10.1177/0144598720923149
0144-5987 2048-4054,1,1,1,0,25,5,30,,10.1177/0144598719900283
2671-7255 2671-7263,1,1,1,0,2,3,5,,10.26866/jees.2021.21.1.60
2662-4966,1,1,1,50,7,4,61,,10.1186/s43591-021-00019-7
1414-4980 1982-0259,1,1,1,0,0,10,10,,10.1590/S1414-49802006000200009
2085-5842 2528-0759,1,1,1,0,6,19,25,,10.20473/jipk.v10i1.8516
2085-5842 2528-0759,1,1,1,0,69,21,90,,10.20473/jipk.v11i1.10770
2341-2747 2341-3050,1,1,1,0,0,23,23,,10.4995/vlc.2017.3913
2589-7101,1,1,1,2,2,5,9,,10.31182/cubic.2019.2.016
2589-7101,1,1,1,0,6,7,13,,10.31182/cubic.2019.2.015
2589-7101,1,1,1,1,1,1,3,,10.31182/cubic.2018.1.013
2589-7101,1,1,1,0,3,3,6,,10.31182/cubic.2018.1.004
2589-7101,1,1,1,4,7,11,22,,10.31182/cubic.2018.1.000
2365-9440,1,1,1,0,44,7,51,,10.1186/s41239-019-0132-7
0043-6275 1613-978X,1,1,1,1,4,17,22,,10.1007/s10273-021-2941-2
2157-9024,1,1,1,2,45,5,52,,10.1038/s41389-021-00337-8
2522-5782,1,1,1,0,32,12,44,,10.1186/s42238-021-00080-2
2075-3470 2311-9446,1,1,1,18,0,11,29,,10.17759/cpp.2021290202
0048-5705 1451-9283,1,1,1,0,8,0,8,,10.2298/PSI0801005Z
2375-1576,1,1,1,0,5,56,61,,10.3934/medsci.2016.1.41
2472-7245,1,1,1,36,0,4,40,,10.2106/JBJS.OA.20.00010
1609-8595 2412-0774,1,1,1,0,1,12,13,,10.28925/1609-8595.2020.2.6
1989-9947,1,1,1,0,36,23,59,,10.4995/var.2020.13134
2190-9172 2193-8210,1,1,1,0,11,4,15,,10.1007/s13555-020-00374-y
2198-0802,1,1,1,0,23,0,23,,10.1186/s40691-021-00252-x
2571-6182,1,1,1,2,41,1,44,,10.3390/plasma4020015
0976-5042 0976-5050,1,1,1,5,0,1,6,,10.1055/s-0040-1715282
0020-0883 1988-3234,1,1,1,1,2,1,4,,10.3989/ic.11.133
0020-0883 1988-3234,1,1,1,0,0,2,2,,10.3989/ic.11.076
0020-0883 1988-3234,1,1,1,1,0,6,7,,10.3989/ic.10.065
0020-0883 1988-3234,1,1,1,0,16,5,21,,10.3989/ic.11.086
0020-0883 1988-3234,1,1,1,3,14,2,19,,10.3989/ic.10.033
2042-0056 2090-8105,1,1,1,0,24,6,30,,10.1155/2021/9988841
2056-4538,1,1,1,0,17,2,19,,10.1002/cjp2.172
2056-4538,1,1,1,0,28,2,30,,10.1002/cjp2.169
2624-5647,1,1,1,0,150,3,153,,10.3390/gidisord2040039
2689-2820,1,1,1,0,5,7,12,,10.1089/PMR.2020.0096
